Liked Songs
The King - Live From The Studio	Sarah Kinsley	The King (Live From The Studio)	spotify:track:6F8DtmwjdxsSEjCIM897Cw
Caught Up In A Dream	Sarah Kinsley	The King	spotify:track:6diUWzBgTJBAsjo8Bnpjts
The King	Sarah Kinsley	The King	spotify:track:4M6XHrTc4RtdgKN9gzEAM6
Nocturne No. 13 in C minor Op.48-1	角野隼斗, Frédéric Chopin	HAYATOSM	spotify:track:1m0bK2Bvwywk6Fzf9jPJeD
Jenny (I Wanna Ruin Our Friendship)	Studio Killers	Jenny (I Wanna Ruin Our Friendship)	spotify:track:4JLBDUYSaOMPYND0iWeSWQ
Come & Go (with Marshmello)	Juice WRLD, Marshmello	Legends Never Die	spotify:track:2Y0wPrPQBrGhoLn14xRYCG
Before You Go	Lewis Capaldi	Divinely Uninspired To A Hellish Extent (Extended Edition)	spotify:track:2gMXnyrvIjhVBUZwvLZDMP
Don't Start Now	Dua Lipa	Future Nostalgia	spotify:track:3PfIrDoz19wz7qK7tYeu62
Super Smash Bros Brawl Drill Beat (Life Ain't Fair)	Shae OT	Super Smash Bros Brawl Drill Beat (Life Ain't Fair)	spotify:track:73PPGDE65hW7SaZ1zO5mud
Bad Habits	Ed Sheeran	=	spotify:track:3rmo8F54jFF8OgYsqTxm5d
Carsick	Maro	Carsick	spotify:track:25lfqgSddWnl3R1mBZCAS5
All The World Is Green	Tom Waits	Blood Money (Remastered)	spotify:track:4mBEFc7XQuJa9w4mNLIZNp
Treat You Better	Shawn Mendes	Illuminate	spotify:track:3QGsuHI8jO1Rx4JWLUh9jd
Lights Are On	Tom Rosenthal	Z-Sides	spotify:track:4IhTXiZLKATmwhMZIb1GQN
cut my fingers off	Ethan Bortnick	cut my fingers off	spotify:track:32R0306OOQN1q0XJzoi9NH
Sorry	Justin Bieber	Purpose (Deluxe)	spotify:track:09CtPGIpYB4BrO8qb1RGsF
Freaks	Surf Curse	Freaks	spotify:track:7EkWXAI1wn8Ii883ecd9xr
New Rules	Dua Lipa	Dua Lipa	spotify:track:6tF92PMv01Ug9Dh8Rmy6nH
Woman	Doja Cat	Planet Her	spotify:track:6Uj1ctrBOjOas8xZXGqKk4
Get Into It (Yuh)	Doja Cat	Planet Her	spotify:track:0W6I02J9xcqK8MtSeosEXb
Nuestra Canción	Monsieur Periné, Vicente Garcia	Caja de Música	spotify:track:5reQI13tWWYDLMrGcUF4Mk
WFM	Realestk	WFM	spotify:track:18ddJHQ7CUzNBiy55L0Xjj
this is what falling in love feels like	JVKE	this is what falling in love feels like	spotify:track:4UG2Fm0E98LhE2dlNxiAXx
Pluto Projector	Rex Orange County	Pony	spotify:track:4EWBhKf1fOFnyMtUzACXEc
Better Now	Post Malone	beerbongs & bentleys	spotify:track:7dt6x5M1jzdTEt8oCbisTK
Icon	Jaden	SYRE	spotify:track:22nyEAEM29tcBRhukR089b
Stuck In The Middle	Tai Verdes	Stuck In The Middle	spotify:track:4y3BUo2hp0MxylfbUaqRyJ
Better Days (NEIKED x Mae Muller x Polo G)	NEIKED, Mae Muller, Polo G	Better Days (NEIKED x Mae Muller x Polo G)	spotify:track:6f5ExP43esnvdKPddwKXJH
Funky Galileo	Sure Sure	Funky Galileo	spotify:track:0TAHhMjG17P5pzlSm1sgSl
Talking to the Moon	Bruno Mars	Doo-Wops & Hooligans	spotify:track:161DnLWsx1i3u1JT05lzqU
Lonely (with benny blanco)	Justin Bieber, benny blanco	Lonely (with benny blanco)	spotify:track:4y4spB9m0Q6026KfkAvy9Q
Tainted Love	Soft Cell	Non-Stop Erotic Cabaret	spotify:track:3tps59cDFyw6dA5QtL6vxg
You Belong With Me (Taylor’s Version)	Taylor Swift	Fearless (Taylor’s Version): The I Remember What You Said Last Night Chapter	spotify:track:4P7LVHDbzn7aI6wWRh5AHc
Blank Space	Taylor Swift	1989	spotify:track:1p80LdxRV74UKvL8gnD7ky
Love Story (Taylor’s Version)	Taylor Swift	Love Story (Taylor’s Version)	spotify:track:3CeCwYWvdfXbZLXFhBrbnf
Shake It Off	Taylor Swift	1989	spotify:track:5xTtaWoae3wi06K5WfVUUH
I Knew You Were Trouble.	Taylor Swift	Red	spotify:track:72jCZdH0Lhg93z6Z4hBjgj
Party In The U.S.A.	Miley Cyrus	The Time Of Our Lives	spotify:track:5Q0Nhxo0l2bP3pNjpGJwV1
Está Dañada	Ivan Cornejo	Alma Vacía	spotify:track:6G2xXQRSZlEzYsUEb3uvuR
Time of Our Lives	Pitbull, Ne-Yo	Globalization	spotify:track:2bJvI42r8EF3wxjOuDav4r
Locked out of Heaven	Bruno Mars	Unorthodox Jukebox	spotify:track:3w3y8KPTfNeOKPiqUTakBh
Heather	Conan Gray	Kid Krow	spotify:track:4xqrdfXkTW4T0RauPLv3WA
Waiting For Love	Avicii	Stories	spotify:track:2P4OICZRVAQcYAV2JReRfj
I'm the One (feat. Justin Bieber, Quavo, Chance the Rapper & Lil Wayne)	DJ Khaled, Justin Bieber, Quavo, Chance the Rapper, Lil Wayne	Grateful	spotify:track:1jYiIOC5d6soxkJP81fxq2
Rockabye (feat. Sean Paul & Anne-Marie)	Clean Bandit, Sean Paul, Anne-Marie	Rockabye (feat. Sean Paul & Anne-Marie)	spotify:track:5knuzwU65gJK7IF5yJsuaW
Needles and Dalgona	Park Min Joo	Squid Game (Original Soundtrack from The Netflix Series)	spotify:track:4ZcrC5jf6Sj0AiEXEEDnRz
New Home	Austin Farwell	New Home	spotify:track:707BRCe5feUySwv7141QeA
New Home (Slowed)	Austin Farwell	New Home (Slowed)	spotify:track:6h6runZeeczWEuEW2pFvYW
Kilby Girl	The Backseat Lovers	When We Were Friends	spotify:track:1170VohRSx6GwE6QDCHPPH
World Is Spinning	DMAD	World Is Spinning	spotify:track:313F7TP2xczgB8H2aW5eTH
edamame (feat. Rich Brian)	bbno$, Rich Brian	edamame (feat. Rich Brian)	spotify:track:1uMHCAyGmHqyygoNRuo7MV
DOLLA SIGN SLIME (feat. Megan Thee Stallion)	Lil Nas X, Megan Thee Stallion	MONTERO	spotify:track:7zQirOExB0VR8yWUOqYeio
Lost In Japan	Shawn Mendes	Shawn Mendes	spotify:track:79esEXlqqmq0GPz0xQSZTV
GUY.exe	Superfruit	Future Friends	spotify:track:3JTjLyrnevl9ASw3ayGO2P
love nwantiti (ah ah ah)	CKay	CKay The First	spotify:track:2Xr1dTzJee307rmrkt8c0g
Gangsta's Paradise	Coolio, L.V.	Gangsta's Paradise	spotify:track:7lQWRAjyhTpCWFC0jmclT4
Wildest Dreams (Taylor's Version)	Taylor Swift	Wildest Dreams (Taylor's Version)	spotify:track:1Ov37jtRQ2YNAe8HzfczkL
Swing Lynn	Harmless	I'm Sure	spotify:track:6hIOunhsLUT66KQgZV5dMD
Midsummer Madness	88rising, Joji, Rich Brian, Higher Brothers, AUGUST 08	Head In The Clouds	spotify:track:6TodWdTSDfzwgYynTZSvJn
Space Song	Beach House	Depression Cherry	spotify:track:7H0ya83CMmgFcOhw0UB6ow
TALES OF DOMINICA	Lil Nas X	MONTERO	spotify:track:5S4PZ7AuYlYiVIVik3wHUf
Mr Bean Animated Series Theme Tune	Howard Goodall	Mr Bean Animated Series Theme Tune	spotify:track:03eAQG4zEYLRnsHwkzlUJQ
La Valse de L'Amour	Patrick Doyle	Cinderella (Original Motion Picture Soundtrack)	spotify:track:0BNQdhKugKzoezQVkHB1TA
Stay in the Pocket	Joel P West	Shang-Chi and the Legend of the Ten Rings (Original Score)	spotify:track:0mT1MVfvkYQcTdslT5GGko
Swan Song	Saweetie, NIKI	Shang-Chi and The Legend of The Ten Rings: The Album	spotify:track:790TzR1UxBXVMFSGq8p7bv
Act Up	Rich Brian, EARTHGANG	Shang-Chi and The Legend of The Ten Rings: The Album	spotify:track:36Ajx3OHw1qOAjS4tJs38V
Freakin' Out On the Interstate	Briston Maroney	Freakin' Out On The Interstate (Acoustic Version [Live])	spotify:track:0awZwmlC6pxH65KTZpadmX
The 90s	FINNEAS	The 90s	spotify:track:6xmlFb4Ld15YysAmRQ545N
Wants and Needs (feat. Lil Baby)	Drake, Lil Baby	Scary Hours 2	spotify:track:65OVbaJR5O1RmwOQx0875b
Dinero	Trinidad Cardona	Dinero	spotify:track:3ggtU1ZOKO8ZNiqPNyXGcm
Who Do You Think You Are Kidding, Mr Hitler? - Theme from 'Dad's Army'	Bud Flanagan	Who Do You Think You Are Kidding, Mr Hitler? (Theme from 'Dad's Army')	spotify:track:6Bk862WUSCGxVclWkrmRfS
Happier Than Ever	Billie Eilish	Happier Than Ever	spotify:track:4RVwu0g32PAqgUiJoXsdF8
INDUSTRY BABY (feat. Jack Harlow)	Lil Nas X, Jack Harlow	INDUSTRY BABY (feat. Jack Harlow)	spotify:track:27NovPIUIRrOZoCHxABJwK
12th Street Rag	Louis Armstrong	Jazz Band: The Best of New Orleans Jazz	spotify:track:1bbDgeS448j3HHaTYBT3nP
String Quartet No. 4 in C Minor, Op. 18 No. 4: 1. Allegro ma non tanto	Ludwig van Beethoven, Emerson String Quartet	Beethoven:The String Quartets	spotify:track:0IVXXd72Q64UCFBuAOCzP1
Can't Take My Eyes off You	Frankie Valli	The Very Best of Frankie Valli & The 4 Seasons	spotify:track:6ft9PAgNOjmZ2kFVP7LGqb
This December	Ricky Montgomery	Montgomery Ricky	spotify:track:3gjRRs7gmh3Euynu1cau1d
Chiquitita	ABBA	Voulez-Vous	spotify:track:762B4bOcXF7I2Y8UlKTyTy
Mayonaka no Door / Stay With Me	Miki Matsubara	Miki Matsubara Best Collection	spotify:track:2BHj31ufdEqVK5CkYDp9mA
Brazil	Declan McKenna	What Do You Think About the Car?	spotify:track:4sNG6zQBmtq7M8aeeKJRMQ
Favorite Liar	The Wrecks	We Are The Wrecks	spotify:track:1scwknKtBQpreYy6MSoJqJ
The Adults Are Talking	The Strokes	The New Abnormal	spotify:track:5ruzrDWcT0vuJIOMW7gMnW
This Will Be (An Everlasting Love)	Natalie Cole	Inseparable	spotify:track:0PDCewmZCp0P5s00bptcdd
Bongo Cha Cha Cha (Italian Version) - 2005 Remaster	Caterina Valente	Bongo Cha Cha Cha (Italian Version) [2005 Remaster]	spotify:track:7tmvABR2QuR4glPO0P0MzF
Who We Want to Be	Tom Day	2012	spotify:track:7eBqNSGi5jOBQZDiecXJas
Your Power	Billie Eilish	Your Power	spotify:track:5qNh5WtzMbfpSj2jLlBkoD
Dancing In The Moonlight	King Harvest	Dancing In The Moonlight	spotify:track:55GxhCTq6SY3tFTVh7z1nR
Rosalina in the Observatory 3 (From "Super Mario Galaxy") [Piano Version]	Streaming Music Studios	Super Mario Galaxy - A Piano Collection	spotify:track:00UNtiu2tLRrGuHPVS3Cse
Libertango	Astor Piazzolla, Yo-Yo Ma, Jorge Calandrelli	Piazzolla: Soul of the Tango (Remastered)	spotify:track:0XU7bJxE8WqKVWNZRol3vw
Big Top Polka	The Little Street Band, Eric Gemsa	Parade: Circus, Fun Fair, Barrel Organ, Accordion	spotify:track:6k3NSjCxsyhN2vKdk8tNiE
Avatar's Love	Samuel Kim	The Power of Balance	spotify:track:0s3djTXa7o53xNE9zrxwya
deja vu	Olivia Rodrigo	deja vu	spotify:track:61KpQadow081I2AsbeLcsb
Sunflower	Rex Orange County	Sunflower	spotify:track:4EpZ4eYuZOwPSSwyqpdHnJ
Karma	Sarah Kinsley	Karma	spotify:track:3tEfPRnUgsQTYOtepBYxdZ
Levitating (feat. DaBaby)	Dua Lipa, DaBaby	Future Nostalgia	spotify:track:5nujrmhLynf4yMoMtj8AQF
MONTERO (Call Me By Your Name)	Lil Nas X	MONTERO (Call Me By Your Name)	spotify:track:67BtfxlNbhBmCDR2L2l8qd
Dying Is a Beautiful Thing to Do	EASHA	Dying Is a Beautiful Thing to Do	spotify:track:1LhCEGscbx07mgfOUZVsZm
Scene I, Kyoto	Umitaro Abe	Cahier de musique / 音楽手帖	spotify:track:6iTAlzX1ADGkkLIhwyGDtx
Crazy In Love (feat. Jay-Z)	Beyoncé, JAY-Z	Dangerously In Love	spotify:track:5IVuqXILoxVWvWEPm82Jxr
Rain Song - English Version	Emile Mosseri	Rain Song (from the film "Minari")	spotify:track:1pRFz7w2pVnYvl4kUx3LiJ
Jacob's Prayer	Emile Mosseri	Minari (Original Motion Picture Soundtrack)	spotify:track:6fHdMf1m47mDBcwvOiRGxQ
Rain Song	Emile Mosseri, Han Ye-ri	Minari (Original Motion Picture Soundtrack)	spotify:track:5ycC7I02VDiWjAxaDOuH5A
Big Country	Emile Mosseri	Minari (Original Motion Picture Soundtrack)	spotify:track:2FH1R4lNVQQx64VLEPLOhF
Jacob and the Stone	Emile Mosseri	Minari (Original Motion Picture Soundtrack)	spotify:track:2nltARCkZyrzjQANViDpuX
Classic	MKTO	MKTO	spotify:track:2Dz8KeCYs9awlwUJStJlmh
The Swan	Camille Saint-Saëns, Philippe Entremont, Gaby Casadesus, Yo-Yo Ma	Impressions	spotify:track:1ZS9SsAz9G434SdwhoQnEi
Uprising	Muse	Uprising	spotify:track:70shFBdHTcoWWFufXAAPdv
I'm A Believer - Radio Edit	Smash Mouth	All Star Smash Hits	spotify:track:5M5mzimlah21xlC1rAuIuY
How Far We've Come	Matchbox Twenty	Exile on Mainstream	spotify:track:0gbLfFlEyVHiKzlZIb0gce
Girlfriend	Avril Lavigne	The Best Damn Thing (Expanded Edition)	spotify:track:45hOioMDJktr86iKDHC8gr
Tango jalousie	Jacob Gade, Sakari Oramo, Wiener Philharmoniker	J. Gade: Tango jalousie	spotify:track:6JKV8DP57kqDRkKuWfIdeA
Danzón No.2 - Live At Centro de Acción Social por la Música, Sala Simón Bolivar, Caracas / 2008	Arturo Márquez, Simón Bolívar Youth Orchestra of Venezuela, Gustavo Dudamel	Fiesta	spotify:track:2JU5PrwuA7VY3MrutRs72h
Valse Sentimentale, Op. 51, No. 6	Misha Quint, Svetlana Gorokhovich	Valse Sentimentale: Tchaikovsky, Shostakovich, Stravinsky	spotify:track:1RvwkB97peLcc6NiHyCmQa
Break My Heart Again	FINNEAS	Blood Harmony (Deluxe)	spotify:track:7gGBgh0bVxHPgZjA505bo9
Let's Fall in Love for the Night	FINNEAS	Blood Harmony (Deluxe)	spotify:track:3n5te2xbUAPjzAnhLgA42z
What They'll Say About Us	FINNEAS	What They'll Say About Us	spotify:track:27Y1N4Q4U3EfDU5Ubw8ws2
Avalon	Louis Armstrong, The Dukes Of Dixieland	Louie and the Dukes of Dixieland	spotify:track:1iZhUkk7ZaX2v9ED3eJ97E
Washington and Lee Swing	Louis Armstrong, The Dukes Of Dixieland	Louie and the Dukes of Dixieland	spotify:track:6IGKStdwEnUSZqfA2XCdQV
New Orleans	Louis Armstrong, The Dukes Of Dixieland	Louie and the Dukes of Dixieland	spotify:track:5gNa14HEpjVNc89ZaawXm0
Just a Closer Walk with Thee	Louis Armstrong, The Dukes Of Dixieland	Louie and the Dukes of Dixieland	spotify:track:74yuOCRSUaDcVPIBtoT6Fm
Bourbon Street Parade	Louis Armstrong, The Dukes Of Dixieland	Louie and the Dukes of Dixieland	spotify:track:4YCgX4BCzlFkMoFyS9P4Mc
Hound Dog - Remastered	Elvis Presley	The Essential Elvis Presley	spotify:track:0mN7usMZ6ndPSIl545pPUz
Love Me Tender	Elvis Presley	The Essential Elvis Presley	spotify:track:7LSGjWtza5Y8itm6Cpbj1s
I Follow	CASTLEBEAT	VHS	spotify:track:4RqVsGYERv5pmwVroKWPiu
Therefore I Am	Billie Eilish	Therefore I Am	spotify:track:54bFM56PmE4YLRnqpW6Tha
Bang! (feat. Hayley Kiyoko) - AhhHaa Remix	AJR, Hayley Kiyoko, AhhHaa	Bang! (feat. Hayley Kiyoko) [AhhHaa Remix]	spotify:track:4Fi00h3wo3P8gmhAHT1qX4
Mafi Mennik	Aziz Maraka	Mafi Mennik	spotify:track:7KpMGvnrttA4zqqRm7cx4a
Dynamite	BTS	Dynamite (DayTime Version)	spotify:track:0t1kP63rueHleOhQkYSXFY
Streetcar	Daniel Caesar	Pilgrim's Paradise	spotify:track:7Cu2COdH93MnuireuKNiS3
Uma Thurman	Fall Out Boy	American Beauty/American Psycho	spotify:track:5PUawWFG1oIS2NwEcyHaCr
Chand Sifarish	Jatin-Lalit, Shaan, Kailash Kher, Prasoon Joshi	Fanaa	spotify:track:5EYZZvmNAH5VZCwuzYJqoA
Tum Hi Ho	Arijit Singh	Aashiqui 2	spotify:track:56zZ48jdyY2oDXHVnwg5Di
Ik Vaari Aa	Pritam, Arijit Singh	Raabta	spotify:track:7fyiYhn7STpHvT5g0lbncC
Drumdown Mambo (feat. Jasiah)	Whethan, Jasiah	Fantasy	spotify:track:0ww5NVJt3quNKHp8Fn5wQK
Talk Dirty (feat. 2 Chainz)	Jason Derulo, 2 Chainz	Talk Dirty	spotify:track:6g6A7qNhTfUgOSH7ROOxTD
Take You Dancing	Jason Derulo	Take You Dancing	spotify:track:59qrUpoplZxbIZxk6X0Bm3
Angelica - From "Pirates of the Caribbean: On Stranger Tides"/Score	Hans Zimmer, Rodrigo y Gabriela	Pirates of the Caribbean: On Stranger Tides	spotify:track:7eukEqNyynUahXubHfYJ79
Up Is Down - From "Pirates of the Caribbean: At World's End"/Score	Hans Zimmer	Pirates of the Caribbean: At World's End	spotify:track:6N10tJfiQqm4wn6KM70aoT
Sofia	Clairo	Immunity	spotify:track:7B3z0ySL9Rr0XvZEAjWZzM
Daddy Issues	John Powell, Hans Zimmer	Kung Fu Panda 2 (Music From The Motion Picture)	spotify:track:3BwALLGlroiovc1yy7kzrI
Po Finds The Truth	John Powell, Hans Zimmer	Kung Fu Panda 2 (Music From The Motion Picture)	spotify:track:77MZvMDdT2u2NB4cgOZWVm
Invasion Begins	John Powell, Hans Zimmer	Kung Fu Panda 2 (Music From The Motion Picture)	spotify:track:75BwOC92ZnRhSGQbRUjb7c
More Cannons!	John Powell, Hans Zimmer	Kung Fu Panda 2 (Music From The Motion Picture)	spotify:track:77PK1vZ6Do78N4JKCeqDkN
My Fist Hungers For Justice	John Powell, Hans Zimmer	Kung Fu Panda 2 (Music From The Motion Picture)	spotify:track:2h0YgIcWyP5OIhWZVeb9Oa
Oogway Ascends	Hans Zimmer, John Powell	Kung Fu Panda (Original Motion Picture Soundtrack)	spotify:track:1dZCiUTIbbvwOCALmzBh9y
Damn I Love Miami	Pitbull, Lil Jon	Bad Boys For Life Soundtrack	spotify:track:1uJQhtjcLJ742RW0mVQgnH
Isolation	Zach Diamond	Isolation	spotify:track:18SRNuYjTHSRiNcnWwKrbA
She Looks So Perfect	5 Seconds of Summer	5 Seconds Of Summer	spotify:track:1gugDOSMREb34Xo0c1PlxM
Youngblood	5 Seconds of Summer	Youngblood (Deluxe)	spotify:track:2iUXsYOEPhVqEBwsqP70rE
Love Yourself	Justin Bieber	Purpose (Deluxe)	spotify:track:50kpGaPAhYJ3sGmk6vplg0
Dark Horse	Katy Perry, Juicy J	PRISM (Deluxe)	spotify:track:5jrdCoLpJSvHHorevXBATy
Simla	Stephen Warbeck	Indian Summers (Original Television Soundtrack)	spotify:track:410mcux0OMUBWOUa5SySRQ
September/The Joker	Earth, Wind & Fire, Fatboy Slim	Babel - Music From And Inspired By The Motion Picture	spotify:track:1yW6zNGmBCP95LLy2w1p1O
Down To The Bottom	Dorothy	Down To The Bottom	spotify:track:5jddjli3YTIxueb3xFdLaA
Reach Out I'll Be There - Single Version / Mono	Four Tops	The Ultimate Collection: Four Tops	spotify:track:2VwRmAIjgmwNPDh4eMK1EH
Tea for Two (Solo)	Django Reinhardt	Work at Home With Django Reinhardt	spotify:track:3mtQF8r0usKahcqakj8o5J
Minor Swing	Django Reinhardt, Stéphane Grappelli, Quintette du Hot Club de France	Djangologie Vol6 / 1937	spotify:track:0NDjQezJaEC1KX9TfwEfzf
The St. Louis Blues	Hugh Laurie	Didn't It Rain	spotify:track:7lHL8ncx1ZNEzR9AHoLkKE
Kiss of Fire	Hugh Laurie	Didn't It Rain	spotify:track:6UPCQYqVGYMq2Zuq39nEUV
Einaudi: Snow Prelude No. 3	Ludovico Einaudi, Dalal	Classical Chillout	spotify:track:1QDk71EkZ3yo6Xv8SiW81l
Piano Concerto No. 1 in B-Flat Minor, Op. 23: Allegro non troppo e molto maestoso	Pyotr Ilyich Tchaikovsky, Van Cliburn, Kirill Kondrashin	Tchaikovsky: Concerto No. 1/Rachmaninoff: Concerto No. 2	spotify:track:7dMKKLuDqwGxPN29dmale9
Don't Give Up On Me - (From "Five Feet Apart")	Andy Grammer	Don't Give Up On Me (with R3HAB)	spotify:track:5N8iCZZbqwxmQKUUabbnd3
6 Stucke, Op. 32: 6 Pieces, Op. 32: No. 3. Rustle of Spring	Christian Sinding, Christian Ihle Hadland	Sinding, C.: Violin and Piano Music	spotify:track:2zh4IJYjNuOBfkm0dCRJqX
Loser	Jagwar Twin	Subject To Flooding	spotify:track:18OXm8xAxwMv0XxadfeqmF
Take Me Home, Country Roads	John Denver	The John Denver Collection, Vol 1: Take Me Home Country Roads	spotify:track:39q7xibBdRboeMKUbZEB6g
Battle! Champion Cynthia	Braxton Burks, Augustine Mayuga Gonzales	Time & Space	spotify:track:0ofWSNMhmj81rL97oSs8MV
Stole the Show	Kygo, Parson James	Cloud Nine	spotify:track:5masKPHeAOVNgxdLebIcK7
Moral of the Story	Ashe	Moral of the Story	spotify:track:2nC3QhMI9reBIOWutbU3Tj
Count on Me II	LUCKI	Alternative Trap	spotify:track:0NuhsAcq78bzMPGwFGS85T
Bella Ciao - Música Original de la Serie la Casa de Papel/ Money Heist	Manu Pilas	Bella Ciao (Música Original de la Serie la Casa de Papel/ Money Heist)	spotify:track:3lWzVNe1yFZlkeBBzUuZYu
Break My Heart	Dua Lipa	Break My Heart	spotify:track:1raaNykBg1bDnWENUiglUA
Cigarette Daydreams	Cage The Elephant	Melophobia	spotify:track:2tznHmp70DxMyr2XhWLOW0
Baby I'm Yours	Arctic Monkeys	Leave Before The Lights Come On	spotify:track:6FLqFu1ApSkUddZ9P4H6Io
Why Do You Feel So Down	Declan McKenna	What Do You Think About the Car?	spotify:track:5Bge1Dsqjc14hhGguYML5w
Symphony No.2 in C minor - "Resurrection" / 5th Movement: Pesante	Gustav Mahler, Wiener Philharmoniker, Gilbert Kaplan	Mahler: Symphony No. 2	spotify:track:1PyI8yYqS0cEzueJAlvVIL
Wherever You Are	Sean Angus Watson	Feels Like This	spotify:track:3ARpYhM6bNYvl36ZOtBXKN
I'm Happy	Sean Angus Watson	Feels Like This	spotify:track:1wK9k0LsPYvSkQ4hxxbmMt
It Ain't Weird	Sean Angus Watson	Feels Like This	spotify:track:0JdvmFkinhus9p3z3V8Nmc
Astronomia	Vicetone, Tony Igy	Astronomia	spotify:track:3hWfKBt3n7j1xqIy6LA5ve
La Vie en rose	Édith Piaf	Eternelle	spotify:track:6RKuyWarJu8SMrflntmyXx
Non, je ne regrette rien	Édith Piaf	Eternelle	spotify:track:3dkIE8P7hvl3tHl9KSb6dA
Planetarium	Justin Hurwitz	La La Land (Original Motion Picture Soundtrack)	spotify:track:70RecAVg5QudOXfJs64sM5
Herman’s Habit	Justin Hurwitz	La La Land (Original Motion Picture Soundtrack)	spotify:track:4f6PUDRYJI51UrZy0jDAxD
Someone In The Crowd	Emma Stone, Callie Hernandez, Sonoya Mizuno, Jessica Rothe	La La Land (Original Motion Picture Soundtrack)	spotify:track:39ncDMVidHOeQgeC5anYZM
Speak Softly Love (From "The Godfather")	The City of Prague Philharmonic Orchestra	The Godfather Trilogy (new Recordings from the Classic Scores)	spotify:track:6g5R7bmEVSiG9b9kytMQPf
My Way (A Mi Manera)	Robin Williams	Happy Feet Music From the Motion Picture	spotify:track:2Z7CfiLTIg5rcF3kWsgBGi
Saint Agnes And The Burning Train	Sting	The Soul Cages	spotify:track:5BByR2UEoYzFB833XNeeJf
Ratatouille Main Theme	Michael Giacchino	Ratatouille (Original Motion Picture Soundtrack)	spotify:track:0AGAl2fZLAoGxGd5dO77Cp
I Wish You Love	Rachael Yamagata	Prime (Original Motion Picture Soundtrack)	spotify:track:1eg5G7VtzKy1qc7GVAw54l
I Don't Know You	The Marías	I Don't Know You	spotify:track:4cJOLN346rtOty3UPACsao
Lovesong (The Way) [feat. Bluets]	Charlie Burg, Bluets	One, Violet	spotify:track:4JkKXuKp2RdbE5M7L4z19Z
Adore You	Harry Styles	Adore You	spotify:track:1M4qEo4HE3PRaCOM7EXNJq
Hot Shower	Chance the Rapper, MadeinTYO, DaBaby	The Big Day	spotify:track:00ko9WaS4jOX1kEk3gvHjf
Really Love	D'Angelo	Black Messiah	spotify:track:2RcanAJpudPNDkyIe9DzKS
Skechers	DripReport	Skechers	spotify:track:4z2JaAVPemYJhFKm7e32RA
Blueberry Faygo	Lil Mosey	Certified Hitmaker	spotify:track:22LAwLoDA5b4AaGSkg6bKW
anna	i.am.orange, fredo disco	sadboysongs.jpg	spotify:track:30ft9YbC5EsknvW4zHe3Qk
Piano Man	Billy Joel	Piano Man (Legacy Edition)	spotify:track:70C4NyhjD5OZUMzvWZ3njJ
FourFiveSeconds	Rihanna, Kanye West, Paul McCartney	FourFiveSeconds	spotify:track:78TTtXnFQPzwqlbtbwqN0y
Run	Joji	Run	spotify:track:6p8eEdiZLKJH8tcjGZuNTK
Runaway	Kanye West, Pusha T	My Beautiful Dark Twisted Fantasy	spotify:track:3DK6m7It6Pw857FcQftMds
Yesterday - Remastered 2015	The Beatles	1 (Remastered)	spotify:track:4E5rL7YL0hVUPqeMSpjEF2
Tommy's Party	Peach Pit	Being So Normal	spotify:track:5OuJTtNve7FxUX82eEBupN
Space Cadet	The Technicolors	Sweat	spotify:track:6mc2JQbl1IJQhgUO0eSvVQ
are you okay?	Winnetka Bowling League	Winnetka Bowling League	spotify:track:7nXfaLpel3ilrP4cavlfi1
DJ Got Us Fallin' In Love (feat. Pitbull)	Usher, Pitbull	Raymond v Raymond (Expanded Edition)	spotify:track:4356Typ82hUiFAynbLYbPn
Bye Bye Blackbird (feat. John Coltrane & Red Garland)	Miles Davis, John Coltrane, Red Garland	'Round About Midnight	spotify:track:3ujbZ2FGIoTQG3v07tmV2D
Sweatpants	Lauv	~how i'm feeling~	spotify:track:4sRryr1aCDIbVdj2LnBwsR
Sedona	Houndmouth	Little Neon Limelight	spotify:track:2kG5litgxXvx6ZRgwO1v7W
One With The Birds	Bonnie Prince Billy, Bryce Dessner, eighth blackbird	When We Are Inhuman	spotify:track:4S3iOZZpe43Put1mtpC9Ek
Who Let The Dogs Out	Baha Men	Who Let The Dogs Out	spotify:track:1H5tvpoApNDxvxDexoaAUo
Life Is Good (feat. Drake)	Future, Drake	Life Is Good (feat. Drake)	spotify:track:5yY9lUy8nbvjM1Uyo1Uqoc
Hey Ya	Sweater Beats, KAMAUU	Hey Ya	spotify:track:6h2qCXYJRuAWo7mxSmkrYn
Thrift Shop (feat. Wanz)	Macklemore & Ryan Lewis, Wanz	The Heist	spotify:track:4YMqbFcDIFiCBd02PzUBcM
Planet X	Calimossa	Habaneros	spotify:track:6WtiJthSHfbA5RIWcUU4TM
Marvin Gaye (feat. Meghan Trainor)	Charlie Puth, Meghan Trainor	Some Type of Love	spotify:track:6ukMqDxnOPOgoHdak7Kyp3
Runaway Baby	Bruno Mars	Doo-Wops & Hooligans	spotify:track:5MMLS3xm12D7N26xlfFApr
Faneto	Chief Keef	Back From The Dead 2	spotify:track:6J1SjVyNDzkZ3sF85Ndd3B
Extremely Loud and Incredibly Close	Alexandre Desplat, Jean-Yves Thibaudet	Extremely Loud and Incredibly Close (Original Motion Picture Soundtrack)	spotify:track:4FnK3GEuekjYXavXPIGlmQ
Wong Chia Chi's Theme	Alexandre Desplat	Lust, Caution	spotify:track:7wsOdebEclWBr80KucGiYn
Dinner Waltz (Traffic Quintet)	Alexandre Desplat, Traffic Quintet	Lust, Caution	spotify:track:5FNphyIK5aLcvkBlWeWNGm
Exodus	Alexandre Desplat	Lust, Caution	spotify:track:1sMko5B6wWS65B5lyjU99r
Mambo No 5	Pérez Prado	Mambo No 5	spotify:track:6fJnlY8rYqC37J2u2OeEMf
Tik-A-Tee, Tik-A-Tay	Dean Martin	The Essential Dean Martin	spotify:track:1d7nWD7CdtUGuYKHXCIZ4j
Sway (Quien Sera)	Dean Martin	The Essential Dean Martin	spotify:track:3tbkqSN2sm2GSBWukZPfpb
That's Amore - 1998 Remastered	Dean Martin	The Essential Dean Martin	spotify:track:2yVKRJ026MOBElS97mp2Xl
Everybody Loves Somebody	Dean Martin	The Reprise Years	spotify:track:78VG6M1i7JQXBdygmWFwye
Mambo No. 5 (a Little Bit of...)	Lou Bega	A Little Bit of Mambo	spotify:track:6x4tKaOzfNJpEJHySoiJcs
FRIENDS	Marshmello, Anne-Marie	FRIENDS	spotify:track:08bNPGLD8AhKpnnERrAc6G
1812 Overture	Pyotr Ilyich Tchaikovsky, Royal Philharmonic Orchestra, Philip Ellis	Last Night of the Proms	spotify:track:6oWacAPUt8LMXqRkEk2MNg
High Fashion (feat. Mustard)	Roddy Ricch, Mustard	Please Excuse Me for Being Antisocial	spotify:track:07KXEDMj78x68D884wgVEm
SWEET	BROCKHAMPTON	SATURATION II	spotify:track:2DgMxFMUQRPthW4ROhjen1
hope is a dangerous thing for a woman like me to have - but I have it	Lana Del Rey	hope is a dangerous thing for a woman like me to have - but i have it	spotify:track:1PfUKiMDKIlPEF9FfdJawc
Perdido de Amor [Lost in Love]	Luiz Bonfá	Solo in Rio 1959	spotify:track:4xvpttkjjEH0l2hrizYla7
Reflections of Mufasa	Hans Zimmer	The Lion King (Original Motion Picture Soundtrack)	spotify:track:7eQe6PVlm042ArcDA9w9nn
Mr. Blue Sky	Electric Light Orchestra	Out of the Blue	spotify:track:2RlgNHKcydI9sayD2Df2xp
Stay	Post Malone	beerbongs & bentleys	spotify:track:4H7WNRErSbONkM06blBoGc
Tetris	Derek King	Tetris	spotify:track:566MMmfMJwlR7oQgRyW2w8
12 Etudes, Op.10: No.1 In C	Frédéric Chopin, Maurizio Pollini	Chopin: Etudes Opp.10 & 25	spotify:track:0BGn77fTvSPIbvjbAIz1jq
Ice Ice Baby	Vanilla Ice	Vanilla Ice Is Back! - Hip Hop Classics	spotify:track:3XVozq1aeqsJwpXrEZrDJ9
Circles	Post Malone	Hollywood's Bleeding	spotify:track:21jGcNKet2qwijlDFuPiPb
Black Catcher	Vickeblanka	Black Catcher	spotify:track:5RXmLhscstsdvWPN0XtUa0
All Mine	Kanye West	ye	spotify:track:3U21A07gAloCc4P7J8rxcn
She Knows (feat. Amber Coffman & Cults)	J. Cole, Amber Coffman, Cults	Born Sinner	spotify:track:282L6SR4Y8Rs0VUgtEy1Zw
My Oh My (feat. DaBaby)	Camila Cabello, DaBaby	Romance	spotify:track:3yOlyBJuViE2YSGn3nVE1K
Scrawny	Wallows	Nothing Happens	spotify:track:1pNUmVxDiE8t6P1XxcZAv8
Drunk on Halloween	Wallows	Drunk on Halloween	spotify:track:0z9dPcBhJvqO06QMaKelUE
Dance Monkey	Tones And I	Dance Monkey (Stripped Back) / Dance Monkey	spotify:track:2XU0oxnq2qxCpomAAuJY8K
I Love You Baby, I Love You Doll	Parekh & Singh	Ocean	spotify:track:1uC8CoidgacQzx9f01n73h
NO WORRIES	Paycheck	NO WORRIES	spotify:track:3rYXumZsRSssQmzWATw6kc
Evergreen	August Kamp, Joshua Bassett	19: The Musical	spotify:track:4DOmrSKXmDSM3Xk2AOMP2x
IDOL	BTS	Love Yourself 結 'Answer'	spotify:track:2AIWoHr9DF6y4KALCBKWQS
Someone To Spend Time With	Los Retros	Someone To Spend Time With	spotify:track:0qQ9VcVPkWDTnff6HIhISU
Swan Lake (Suite), Op. 20a, TH. 219: I. Scene - Swan Theme	Pyotr Ilyich Tchaikovsky, Berliner Philharmoniker, Mstislav Rostropovich	Tchaikovsky: Ballet Suites (Swan Lake; The Sleeping Beauty; The Nutcraker)	spotify:track:7uZwUTHsTj7sHZL0VUDuSR
Swan Lake (Suite), Op. 20a, TH. 219: II. Valse In A	Pyotr Ilyich Tchaikovsky, Leon Spierer, Eberhard Finke, Berliner Philharmoniker, Mstislav Rostropovich	Tchaikovsky: Ballet Suites (Swan Lake; The Sleeping Beauty; The Nutcraker)	spotify:track:4bEyFhTNwaA3ou55GFCdN7
Swan Lake (Suite), Op. 20a, TH. 219: III. Danse des petits cygnes	Pyotr Ilyich Tchaikovsky, Berliner Philharmoniker, Mstislav Rostropovich	Tchaikovsky: Ballet Suites (Swan Lake; The Sleeping Beauty; The Nutcraker)	spotify:track:7soiuxMmcrTDS51IVBMXlc
Swan Lake (Suite), Op. 20a, TH. 219: IV. Scene	Pyotr Ilyich Tchaikovsky, Leon Spierer, Eberhard Finke, Berliner Philharmoniker, Mstislav Rostropovich	Tchaikovsky: Ballet Suites (Swan Lake; The Sleeping Beauty; The Nutcraker)	spotify:track:2O3YavbPj9KunfTVkhzYbE
Swan Lake (Suite), Op. 20a, TH. 219: V. Danse Hongroise (Czardas)	Pyotr Ilyich Tchaikovsky, Berliner Philharmoniker, Mstislav Rostropovich	Tchaikovsky: Ballet Suites (Swan Lake; The Sleeping Beauty; The Nutcraker)	spotify:track:2LBe5iJelxuvdDDyW4AxAD
Congratulations (feat. Bilal)	Mac Miller, Bilal	The Divine Feminine	spotify:track:1OubIZ0ARYCUq5kceYUQiO
Stay For A While	iann dior	Industry Plant	spotify:track:2AbKro51mAUu7KePC6OkEF
Before You Go	Lewis Capaldi	Before You Go	spotify:track:7ce20yLkzuXXLUhzIDoZih
Boombastic	Shaggy	Mr Lover Lover - The Best Of Shaggy... (Part 1)	spotify:track:1jqLJBQwo7yBCqYQWukLkq
Sunday Best	Surfaces	Where the Light Is	spotify:track:1Cv1YLb4q0RzL6pybtaMLo
Believe In Me	fun.	Believe In Me	spotify:track:5YfkbMilWnR0BuKDbewxQh
Also sprach Zarathustra, Op. 30, TrV 176: 1. Prelude (Sonnenaufgang)	Richard Strauss, Berliner Philharmoniker, Karl Böhm	The 50 Most Essential Classical Music Pieces Ever	spotify:track:6IA8E2Q5ttcpbuahIejO74
Deewangi Deewangi	Shaan, Udit Narayan, Shreya Ghoshal, Sunidhi Chauhan, Rahul Saxena	Om Shanti Om	spotify:track:7emLx4rVwr0tPyjktu7A7U
Ban Ja Rani	Guru Randhawa	Break Out Artist 2017 - Guru Randhawa	spotify:track:3FldfxOBmiLYq9Yy7swkVi
Milegi Milegi	Mika Singh, Sachin-Jigar	Stree	spotify:track:4lyGHwV0KDVaOhvB0R6y86
Talk Too Much	COIN	How Will You Know If You Never Try	spotify:track:4djIFfof5TpbSGRZUpsTXq
The Barber of Seville, Act I: Overture	Gioachino Rossini, James Levine, London Symphony Orchestra	The Barber of Seville	spotify:track:0RXG9tS5Y8qPhovPFpplK1
Pink Lemonade	The Wombats	Glitterbug	spotify:track:1OqbX2MZ6ZzWP7HjMHbdkp
Life's Too Short	Wild Party	Phantom Pop	spotify:track:21xou84xCn9aF4z2N5GzTK
Televised	HUNNY	Windows I	spotify:track:35Ki1lvKPC2sFBD3GmKdRG
Chasin' Honey	Wild Party	Phantom Pop	spotify:track:0Z0iYAtKYswMYXL3kJtdO4
ROXANNE	Arizona Zervas	ROXANNE	spotify:track:1ZPWWSwCkxKfqdp4H0RFCo
Sweet Talk	Saint Motel	saintmotelevision	spotify:track:6kcHg7XL6SKyPNd78daRBL
Cold Cold Man	Saint Motel	My Type EP	spotify:track:6RKGBcDtgzXx21zUjpeu6F
Two Weeks	Grizzly Bear	Veckatimest	spotify:track:0iTpQYzJnYgh7kIxyq8A2O
City Lights	Hall Johnson	Upstate / City Lights	spotify:track:3zRL8CGYNjs2dJ1YJEAacG
Baby, Please - Again Version	Max Diaz	Again	spotify:track:3CuZFvDhwiZdJRT2xV0S3a
La Mejor De Todas	Banda El Recodo	La Mejor De Todas	spotify:track:1F6BAyY4iIzHiZCnUIZDbn
All I Want for Christmas Is You	Mariah Carey	Merry Christmas	spotify:track:0bYg9bo50gSsH3LtXe2SQn
Mariposa	Peach Tree Rascals	Mariposa	spotify:track:6xs6iIX77Cu64T1TdY0aDr
Say You Won't Let Go	James Arthur	Back from the Edge	spotify:track:5uCax9HTNlzGybIStD3vDh
Closed On Sunday	Kanye West	JESUS IS KING	spotify:track:3JWiDGQX2eTlFvKj3Yssj3
Selah	Kanye West	JESUS IS KING	spotify:track:39JRmdKFka1Oe09FoOCPI4
Mundian to Bach Ke	Panjabi MC	Panjabi MC: The Album	spotify:track:6dK1HEHZcQlh24bSU7pTaZ
El Sonidito	Hechizeros Band	Super Estrellas Idolos	spotify:track:1ABT0icyBV5o5rwNM6gN2T
In the Mirror	Peter Salem	Call the Midwife (Music from the TV Series)	spotify:track:6l4LRsQyYkMVYXJVCIox5u
Call the Midwife Theme Tune	Peter Salem	Call the Midwife (Music from the TV Series)	spotify:track:42bRfk534dWPRCrebgUUX8
Come Softly To Me	The Fleetwoods	Come Softly To Me: The Very Best Of The Fleetwoods	spotify:track:603N4XGJUTbK760GLCvIIs
Dear God	Dax	Dear God	spotify:track:6rxpwJPIbY7soTdU8FOmmo
Drive Safe	Rich Brian	The Sailor	spotify:track:6eDfe957aV4sqGnDhlSikJ
Pure Gold	half•alive	Now, Not Yet	spotify:track:06yksZ8eFxWyaCxxnbXd0q
Berenstein	The Band CAMINO	Berenstein	spotify:track:0VXI7SOcGQQ1SLjyJaaIEa
National Anthem Of The Ussr	The Red Army Choir	The Best Of The Red Army Choir	spotify:track:1zPm8UZgIBYRRHNyyhqOpV
L-O-V-E	Nat King Cole	L-O-V-E	spotify:track:4QxDOjgpYtQDxxbWPuEJOy
Can't Take My Eyes Off You	Bailey Pelkman, Randy Rektor	Acoustic Duets	spotify:track:5KGz98O5u5a3Z3KQvnl9d4
Hollywood's Bleeding	Post Malone	Hollywood's Bleeding	spotify:track:7sWRlDoTDX8geTR8zzr2vt
Marche slave, Op. 31, TH 45	Pyotr Ilyich Tchaikovsky, Leonard Bernstein, New York Philharmonic	Tchaikovsky: 1812 Overture; Marche Slave; Romeo and Juliet; Capriccio Italien; Hamlet [Expanded Edition]	spotify:track:4nme70lTDNLI3mdpKrnrO0
La campanella in G-Sharp Minor (From "Grandes études de Paganini", S. 141 / 3)	Franz Liszt, Lang Lang	Liszt - My Piano Hero	spotify:track:2Hnurh1BcigGbCGFOb4Uid
Liebestraume, S541/R211 : No. 3: Nocturne in A-Flat Major	Franz Liszt, Jenő Jandó	Liszt: Scherzo and March / 3 Liebestraume / Berceuse	spotify:track:6GzMz3s0K1YKwRVI36CgRx
BOOMBAYAH	BLACKPINK	SQUARE ONE	spotify:track:3yHQKddM8SVCRnuPSo3HPN
Fantaisie-Impromptu In C Sharp Minor, Op. 66	Frédéric Chopin, Daniil Trifonov	Chopin Evocations	spotify:track:1JpHODSwP0POyWOG16D8WI
Scheherazade, Op. 35: I. Largo e maestoso - Allegro non troppo "The Sea and Sinbad's Ship"	Nikolai Rimsky-Korsakov, New York Philharmonic, Alan Gilbert, Lawrence Rock	Rimsky-Korsakov: Scheherazade	spotify:track:4hB2Mn8sMqHkv9P03fvzuZ
Scheherazade, Op. 35: II. Lento - Andantino "The Legend of the Kalendar Prince"	Nikolai Rimsky-Korsakov, New York Philharmonic, Alan Gilbert, Lawrence Rock	Rimsky-Korsakov: Scheherazade	spotify:track:15jIL0xiVkESkwAN8WCdYQ
Scheherazade, Op. 35: III. Andantino quasi allegretto "The Young Prince and The Young Princess"	Nikolai Rimsky-Korsakov, New York Philharmonic, Alan Gilbert, Lawrence Rock	Rimsky-Korsakov: Scheherazade	spotify:track:3j97tmXy9XOnyJBbD1bM1O
Scheherazade, Op. 35: IV. Allegro molto "Festival at Baghdad"	Nikolai Rimsky-Korsakov, New York Philharmonic, Alan Gilbert, Lawrence Rock	Rimsky-Korsakov: Scheherazade	spotify:track:2bIeXi5GlCZ4M69zmTLF4C
Ho capito che ti amo	Wilma Goich	Wilma Goich 1964	spotify:track:3pwuoxKBhRXYpAOm1Fh45t
Stranger Things	Kyle Dixon & Michael Stein	Stranger Things, Vol. 1 (A Netflix Original Series Soundtrack)	spotify:track:0kwuKfWntoGh0EWyYb7Mpf
Don't Worry Be Happy	Bobby McFerrin	Simple Pleasures	spotify:track:4hObp5bmIJ3PP3cKA9K9GY
Un Giorno Ti Dirò	Nicola Arigliano	Nicola Arigliano - Italian Masterpiece	spotify:track:3OgKVkCj1tJ6hg4ONC7e9S
Olalla	Blanco White	Nocturne EP	spotify:track:0vrlxoXcbwD8Sklwy59N9g
Señorita	Shawn Mendes, Camila Cabello	Shawn Mendes (Deluxe)	spotify:track:6v3KW9xbzN5yKLt9YKDYA2
Internet	Post Malone	Hollywood's Bleeding	spotify:track:4RzpCjByV1NWUGKVQGuej6
Staring At The Sun (feat. SZA)	Post Malone, SZA	Hollywood's Bleeding	spotify:track:2leIuE4fdcJoNMSKu5Yr7a
Sunflower - Spider-Man: Into the Spider-Verse	Post Malone, Swae Lee	Hollywood's Bleeding	spotify:track:4VqTRBvYg0z8C4nsl4Hupy
Allergic	Post Malone	Hollywood's Bleeding	spotify:track:4LIbjDbLweGCrHVw8QbMSb
100 Degrees	Rich Brian	The Sailor	spotify:track:2ZDpSQfBdgkooeXw6oj3Uz
3 Nights	Dominic Fike	Don't Forget About Me, Demos	spotify:track:1tNJrcVe6gwLEiZCtprs1u
TLDR	monom	TLDR	spotify:track:6QlGt8JIfeWVG2diqW9KUe
All Moved In	Bogues	Life, Slowly	spotify:track:5rvqfPSl2AYpF1l0zNUt9o
Danzon No.2	Arturo Márquez, Gustavo Dudamel, Los Angeles Philharmonic	Preciosas Piezas Clásicas de América Latina	spotify:track:3yttrbsDmQxwXBeb8Q9BCN
Praise The Lord (Da Shine) (feat. Skepta)	A$AP Rocky, Skepta	TESTING	spotify:track:7ycWLEP1GsNjVvcjawXz3z
The Well-Tempered Clavier: Book 1, BWV 846-869: 1. Prelude in C Major, BWV 846	Johann Sebastian Bach, Lang Lang	Piano Book (Deluxe Edition)	spotify:track:4SFBV7SRNG2e2kyL1F6kjU
Lucky	Jason Mraz, Colbie Caillat	We Sing. We Dance. We Steal Things.	spotify:track:0IktbUcnAGrvD03AWnz3Q8
Mr. Clean	Yung Gravy	Snow Cougar	spotify:track:5GxnROd93Y7NGt2ci0TwBw
A letter to my younger self	Ambar Lucid	Dreaming Lucid	spotify:track:2m1W73aJNII9wafWkDn8S0
Jocelyn: Berceuse	Benjamin Godard, David Hays, Peter Collins	Brahms: Lullaby; Lullabies and Nocturne for Violin and Piano	spotify:track:3gVSNjxuiLJLO1EOpTvlHq
La Berceuse, aus der Oper 'Jocelyn'	Benjamin Godard, Radio-Sinfonieorchester Stuttgart, Sir Neville Marriner	Barcarole - Favourite Orchestral Pieces	spotify:track:51kbN7CEPywtsxqjz4vdX6
Le Cid Ballet Suite: III. Aragonaise	Jules Massenet, Academy of St. Martin in the Fields, Sir Neville Marriner	Massenet: Ballet Suites	spotify:track:6lm7bhzh9fMPKBkvJoSW1p
Break My Heart Again	FINNEAS	Break My Heart Again	spotify:track:2is19a6HY7ZdWP654IMhEE
Japanese Denim	Daniel Caesar	Get You - Single	spotify:track:1boXOL0ua7N2iCOUVI1p9F
When Did Your Heart Go Missing?	Rooney	Calling The World	spotify:track:60okmgzrYnFh2nXfi0XxWR
First Day Of My Life	Bright Eyes	I'm Wide Awake, It's Morning	spotify:track:5OiaAaIMYlCZONyDBxqk4G
Let's Fall in Love for the Night	FINNEAS	Let’s Fall In Love For The Night	spotify:track:7kQkmyoHCEqwe7QwDbkSXM
Catch	Dresses	Let Down	spotify:track:7dsHYU5bH0qksf8e1loXcl
Changing of the Seasons	Two Door Cinema Club	Changing of the Seasons	spotify:track:3KL3eFVpAVW36M9YrK2Zrk
Killing Me Softly	Joseph Vincent	Killing Me Softly	spotify:track:0yr1u6QnBDMb7M4nYFLLfb
Are You Bored Yet? (feat. Clairo)	Wallows, Clairo	Nothing Happens	spotify:track:57RA3JGafJm5zRtKJiKPIm
Missin' You Like Crazy	Us The Duo	Us	spotify:track:51mwvxRXUktJYBXqq9uXuo
Too Much Time Together	San Cisco	Gracetown	spotify:track:0LcVvD1iPjqkfVdWd7ClfA
Mr. Sandman	The Chordettes	The Chordettes' Best	spotify:track:1T3tP6HvCgDF8ewpRqwM1e
Red Roses	AJ Rafael	Red Roses	spotify:track:5tcduvdpuJZmAre4MUsh4w
Build Me Up Buttercup - Mono	The Foundations	The Foundations	spotify:track:6sPOmDulFtLzfX25zICNrC
She Was Mine (feat. Jesse Barrera)	AJ Rafael, Jesse Barrera	Red Roses	spotify:track:6NV8bM1StHDcWMoTVWix1J
Canzone per te	Sergio Endrigo	I Grandi Successi: Sergio Endrigo	spotify:track:2go5hIXEA3os4FRQLvIkOe
Il Mondo	Jimmy Fontana	40 Grandi Successi	spotify:track:0BOlkmYZ8lVyjjybwUQeEY
Electric Love	BØRNS	Dopamine	spotify:track:2GiJYvgVaD2HtM8GqD9EgQ
Animal	Miike Snow	Miike Snow	spotify:track:6vSq5q5DCs1IvwKIq53hj2
Radetzky March, Op. 228	Johann Strauss I, Cologne New Philharmonic Orchestra, Volker Hartung	Strauss: Waltz in Vienna	spotify:track:5WfphEvHrtWZY3Ds7rSDnc
Strauss Jr., J.: Frühlingsstimmen, Op. 410 (Excerpt)	Johann Strauss II, Wiener Johann Strauss Orchester, Willi Boskovsky	Famous Strauss Waltzes	spotify:track:56YstNT2fL3XXFbMLWYVX8
Vienna Blood Waltz, Op. 354	Johann Strauss II, Leonard Bernstein	Strauss, Jr: Waltzes - Strauss, Sr.: Radetzky March	spotify:track:4yzrSvcUDnIziHt9AAtDVV
Vienna Blood - Waltz Op. 354	Johann Strauss II, Hallé, Bryden Thomson	Johann Strauss II Waltzes, Polkas & Overtures	spotify:track:6xEV7QbhjKAL2UjdAhIO4G
High Hopes	Panic! At The Disco	Pray for the Wicked	spotify:track:1rqqCSm0Qe4I9rUvWncaom
Fireworks Factory	John Powell, Hans Zimmer	Kung Fu Panda 2 (Music From The Motion Picture)	spotify:track:1NDtYW3kGA81J6tXDaPFjX
Prince Ali (Reprise) - From "Aladdin"/Soundtrack Version	Jonathan Freeman	Aladdin Special Edition	spotify:track:6hs8Ky5NIv2VM2qyKvMqaM
Arabian Nights - From "Aladdin"/Soundtrack Version	Bruce Adler	Aladdin Special Edition	spotify:track:31vVcYpecILSQ02PIGdqYi
Prince Ali	Will Smith	Aladdin (Original Motion Picture Soundtrack)	spotify:track:1Pt2STlAgfB1CiEV8mf3CN
hong kong	mxmtoon	hong kong	spotify:track:4CXjkhKrSasVCQ9RhTNpgN
cliché	mxmtoon	cliché	spotify:track:0rhCqFgY0rS3nl6bCfWzJp
prom dress	mxmtoon	prom dress	spotify:track:0X3a2iLqyGMYi4g2WtUaXu
"Moonlight & Roses" Andantino in D-Flat	Edwin Lemare, Fritz Kreisler	Grabaciones Históricas	spotify:track:608Q8hUMDCx0vz6aTFRP0X
Moonlight & Roses (Andantino in D-Flat Major, Op. 83 No. 2)	Freddy Martin & His Orchestra	Golden Age of Light Music: 100 Greatest American Light Orchestras, Vol. 3	spotify:track:06DOKbJor29h5siYq3xFvM
I Do Like to Be Beside the Seaside	Mrs Mills	Piano Favourites	spotify:track:4KcZHA3hU44mxk1Nf1asTy
That's My Girl	Fifth Harmony	7/27 (Deluxe)	spotify:track:2ACOWPLUe4A4KuQ5ioD2od
Please Never Fall in Love Again	Ollie MN	Songs from the Swamp	spotify:track:42H6GeQfrBkT3vTUTdpB1M
wish you were gay	Billie Eilish	WHEN WE ALL FALL ASLEEP, WHERE DO WE GO?	spotify:track:3Fj47GNK2kUF0uaEDgXLaD
bad guy	Billie Eilish	WHEN WE ALL FALL ASLEEP, WHERE DO WE GO?	spotify:track:2Fxmhks0bxGSBdJ92vM42m
Perfect	Ed Sheeran	÷ (Deluxe)	spotify:track:0tgVpDi06FyKpA1z0VMD4v
Death of a Bachelor	Panic! At The Disco	Death of a Bachelor	spotify:track:1BECwm5qkaBwlbfo4kpYx8
Tunnel of Love	ilyTOMMY, Savage Ga$p	Tunnel of Love	spotify:track:1K4OfBFaLleSUaUVjp1l2X
Lohengrin, WWV 75: Prelude To Act I	Richard Wagner, Berliner Philharmoniker, Rafael Kubelik	Wagner: Overtures and Preludes	spotify:track:2CMJhthHe16oGDn6IFH6Yw
Hey, Soul Sister	Train	Save Me, San Francisco (Golden Gate Edition)	spotify:track:4HlFJV71xXKIGcU3kRyttv
Please Mr. Postman - Single Version / Mono	The Marvelettes	Please Mr. Postman	spotify:track:6jX5mso4x00c1EiNMrTU9U
Videotape	Radiohead	In Rainbows	spotify:track:3uxhyRdWVXp7GQvERQl6fA
If I Can't Have You	Shawn Mendes	If I Can't Have You	spotify:track:6LsAAHotRLMOHfCsSfYCsz
Jimbo	fredo disco	Very Cool Music for Very Cool People	spotify:track:7snEelzfUgdNw1ssNNzpbI
Que Nadie Sepa Mi Sufrir	manuel cervantes, La Sonora Dinamita	12 Cumbiazos Vol. 4	spotify:track:3sKGDQWgG1dOihFzAvXwyK
Love Me For The Weekend (with Ashe)	Party Pupils, MAX, Ashe	Love Me For The Weekend (with Ashe)	spotify:track:1jye0ZfUs4eb8iw41UcKSH
Symphony No. 9 in E Minor, Op. 95 "From the New World": IV. Allegro con fuoco	Antonín Dvořák, New York Philharmonic, Alan Gilbert	Dvořák: Symphony No. 9, From the New World	spotify:track:4GdHkkbUtc63Jr3JI5Pm19
The Liberty Bell March	John Philip Sousa, Royal Philharmonic Orchestra, Philip Ellis	Last Night of the Proms	spotify:track:0ipIyLG8vbqqxr0ZOL8oUe
Sucker	Jonas Brothers	Sucker	spotify:track:4y3OI86AEP6PQoDE6olYhO
Budapest	George Ezra	Wanted on Voyage	spotify:track:7q0aQpiLv5tIsupcgQ3Ny4
Never Be Like You (feat. Kai)	Flume, kai	Skin	spotify:track:5WI2ltQIdwgzf1SNE76JyR
Off She Goes	Bad Suns	Disappear Here	spotify:track:277XsneDiv30dhONPCOmrF
Rolling in the Deep	Adele	21	spotify:track:1CkvWZme3pRgbzaxZnTl5X
Set Fire to the Rain	Adele	21	spotify:track:3CKCZ9pfwAfoMZlMncA1Nc
Tunak Tunak Tun	Daler Mehndi	Tunak Tunak Tun	spotify:track:131yybV7A3TmC34a0qE8u8
Bom Diggy	Zack Knight, Jasmin Walia	Bom Diggy - Single	spotify:track:7Dhy1R9NmD96wfr7VJEN37
對不起我的中文不好	Transition 前進樂團	跨越	spotify:track:6J9vgUSMsvTr0j9fB1z10G
Time In A Bottle	Jim Croce	You Don't Mess Around With Jim	spotify:track:1pmYAWY7Kwaj84U3xZxLML
DDU-DU DDU-DU	Vitamin String Quartet	Vitamin String Quartet Performs the Hits of 2018, Vol. 2	spotify:track:4SwHXOYkLJNQZhSVZZqHUm
Rachmaninov: Prelude No. 1 in C-Sharp Minor, Op. 3 No. 2, "The Bells of Moscow"	Sergei Rachmaninoff, Simon Trpčeski	Rachmaninov	spotify:track:73FHnUWDmI526kxaHweWal
Avalon (feat. Frank Vignola Martin Taylor)	David Grisman, Frank Vignola Martin Taylor	First Time Together	spotify:track:3mF1MRbqamvpr3dztFkQZ0
Seraphina (feat. Frank Vignola Martin Taylor)	David Grisman, Frank Vignola Martin Taylor	First Time Together	spotify:track:4fPfFZKBxaR6mhBqCaN64z
Legend	Billy Marchiafava	Legend	spotify:track:027qYIwhcMZGPWfTUhs9BN
Retro Funky - Sundance Remix	Perséphone	Retro Funky	spotify:track:1eEqg0aPf3BoaBl0I4Tuln
Twenty-three	IU	CHAT-SHIRE	spotify:track:3YkDslZvvMixTwgDId0aYB
Yikes!	Billy Marchiafava	Yikes!	spotify:track:0GSUry7Qw9ofdMV9RfvMFC
Yikes	Kanye West	ye	spotify:track:1qsHYUd2c1wFGcn7e63QmG
Gosto de Você	Diskover, Rodrigo Lorio	Gosto de Você	spotify:track:2hqaa3phO1eRyyZuxg3veh
Funkytown	Lipps Inc.	Casablanca Records Greatest Hits	spotify:track:0KQh7AuuZvpTKWhcJa8Pbr
Spirited Away - The Name Of Life - Main Theme	Geek Music	Spirited Away - The Name Of Life - Main Theme	spotify:track:7vflKxzgcq8G7N6W790cFI
DDU-DU DDU-DU	BLACKPINK	DDU-DU DDU-DU	spotify:track:1PMXpTPJfh3ViK8PMZ9ZnY
Dance The Night Away	TWICE	Summer Nights	spotify:track:5ilOXZ0vqTX69rjRubPivH
Hebrides Overture "Fingal's Cave"	Felix Mendelssohn, Joseph Kalichstein, Jaime Laredo, Scottish Chamber Orchestra	Mendelssohn: Piano Concertos 1 & 2 - Hebrides Overture "Fingal's Cave"	spotify:track:6nJ9UiCGbC4Nc7Kwzt0vZZ
With a Little Bit of Luck	Norbert Leo Butz, Joe Hart, Lance Roberts, My Fair Lady Ensemble	My Fair Lady (2018 Broadway Cast Recording)	spotify:track:6EISSNxLTm5Y0WnkWxIODe
Wouldn't It Be Loverly?	Lauren Ambrose, John Treacy Egan, Christopher Faison, Adam Grupper, Justin Lee Miller	My Fair Lady (2018 Broadway Cast Recording)	spotify:track:6b8HkRXKPE29AVqxzMMpib
Supercalifragilisticexpialidocious - From "Mary Poppins"/Soundtrack Version	Julie Andrews, Dick Van Dyke, The Pearlie Chorus	The Sherman Brothers Songbook	spotify:track:5mXBaDm21IbxvWSl1AHCpq
Cake By The Ocean	DNCE	SWAAY	spotify:track:42ftjU4cTN5UTRksyqBKZJ
The Best	Kat Edmonson	The Big Picture	spotify:track:204FXnZQAksidBN3dpNyja
You Can't Break My Heart	Kat Edmonson	The Big Picture	spotify:track:4bjk2UZ0y9RpI54GVToD5x
Oh My Love	Kat Edmonson	The Big Picture	spotify:track:4HlLLrS6UrQD5x2ev4Vu1h
Bohemian Rhapsody - Remastered 2011	Queen	A Night At The Opera (Deluxe Remastered Version)	spotify:track:7tFiyTwD0nx5a1eklYtX2J
Pennies From Heaven	Louis Prima, Sam Butera & The Witnesses	The Call Of The Wildest (Expanded Edition)	spotify:track:4tmy6FB76bR5eLmx0zO1mn
I've Got You Under My Skin	Louis Prima, Keely Smith	Capitol Collectors Series	spotify:track:2DlYJ5MGLpDGzYhF76LXtI
JAPAN	Famous Dex	Dex Meets Dexter	spotify:track:5PTG6rrL6EPFD9E2QMI2pl
1 Thot 2 Thot Red Thot Blue Thot	Yung Gravy	Snow Cougar	spotify:track:7LptQZjp5wgdYDQZPjOV9O
MEGALOVANIA	Toby Fox	UNDERTALE Soundtrack	spotify:track:2WpstnkNuH6dUnm3fVLCpU
When You're Smiling/The Sheik Of Araby - Remastered	Louis Prima, Keely Smith, Sam Butera & The Witnesses	Capitol Collectors Series	spotify:track:2WIRY7DKGxrf5lCiCYwTEJ
Auld Lang Syne	Samuel Bath	Soft Christmas	spotify:track:0zQ4J02tYSeCCwHIyXYoUG
Gaîté parisienne: No. 23: Barcarolle	Jacques Offenbach, Arthur Fiedler, Boston Pops Orchestra	Offenbach: Gaîté parisienne	spotify:track:3q4Y3PqfJUFCIxaSA0H0Aa
Symphony No. 8 in B Minor, D. 759 "Unfinished": 1. Allegro moderato	Franz Schubert, Berliner Philharmoniker, Herbert von Karajan	Schubert: Symphony No.8 "Unfinished" / Mendelssohn: Symphony No.4 "Italian"	spotify:track:3FMW2qArFQCYgkACKiqyeq
'O sole mio (Arr. Chiaramello)	Eduardo di Capua, Alfredo Mazzucchi, Luciano Pavarotti, National Philharmonic Orchestra, Giancarlo Chiaramello	The Ultimate Collection	spotify:track:6APIeDnJBcgEFOWv5plRhD
Dynamite	Taio Cruz	Rokstarr	spotify:track:1DqdF42leyFIzqNDv9CjId
When I Was Your Man	Bruno Mars	Unorthodox Jukebox	spotify:track:0nJW01T7XtvILxQgC5J7Wh
You Belong With Me	Taylor Swift	Fearless	spotify:track:3GCL1PydwsLodcpv0Ll1ch
對面的女孩看過來	Richie Jen	滾石香港黃金十年-任賢齊精選	spotify:track:51vo4MbGHmzEuW5Nrk6flg
Cynthia: Champion Cynthia (From "Pokémon Diamond and Pearl") / Battle! Champion (From "Pokémon Diamond and Pearl")	Qumu	Cynthia: Champion Cynthia (From "Pokémon Diamond and Pearl") / Battle! Champion (From "Pokémon Diamond and Pearl")	spotify:track:3GPVWPA7FGwt9Zg7QVDKGl
All I Ask Of You	Andrew Lloyd Webber, Patrick Wilson, Emmy Rossum	The Phantom Of The Opera (Original Motion Picture Soundtrack)	spotify:track:5klrh466oGToybceGHPGAX
Symphony No. 3 in D Minor: VI. Langsam. Ruhevoll. Empfunden	Gustav Mahler, Bavarian Radio Symphony Orchestra, Bernard Haitink	Mahler: Symphony No. 3 in D Minor	spotify:track:0Pix5jZcIurwwdbJj0KatI
Prelude / The Sound of Music	Irwin Kostal, Julie Andrews	The Sound of Music - Original Soundtrack Recording	spotify:track:6rbpI4fchfJx1IgCBowc8m
Still into You	Vitamin String Quartet	VSQ Performs the Hits of 2013, Vol. 2	spotify:track:2EIs3E71HAGJ3oh4Jb7ksL
Climb Ev'ry Mountain (Reprise)	Chorus & Orchestra	The Sound of Music - Original Soundtrack Recording	spotify:track:1vzrlknOYpj3eTjmJolums
Climb Ev'ry Mountain	Peggy Wood	The Sound of Music - Original Soundtrack Recording	spotify:track:1Eeb3nwdr3e1tyCYgb1oqd
The Sound of Music	Charmian Carr, Heather Menzies, Nicholas Hammond, Duane Chase, Angela Cartwright, Kym Karath, Debbie Turner, Bill Lee	The Sound of Music (50th Anniversary Edition)	spotify:track:1eQkeRWuEFcdf5Bb0P3Tsz
Mi Gente	J Balvin, Willy William	Vibras	spotify:track:7COfe3P7KgfwDwIRB8LIDw
STOOPID	6ix9ine, Bobby Shmurda	STOOPID	spotify:track:1jQvUmf16VE9WQCPuK2e8K
The Young Person's Guide to the Orchestra, Op.34	Benjamin Britten, London Symphony Orchestra	Britten: The Young Person's Guide to the Orchestra; Simple Symphony, etc.	spotify:track:6BKcbGaoqA8BeaJX0F2hbz
A Christmas Festival	Felix Mendelssohn, Franz Xaver Gruber, George Frideric Handel, James Lord Pierpont, John Francis Wade, Leroy Anderson, Traditional, Arthur Fiedler, Boston Pops Orchestra	Pops Christmas Party	spotify:track:6v3ZSRI7NXfZwYHpkSE32Q
Sleigh Ride	Leroy Anderson, Arthur Fiedler, Boston Pops Orchestra	Pops Christmas Party	spotify:track:1qj6OC6QHnbxMbwBSFjg4t
Cavalleria rusticana: Act I: Intermezzo sinfonico	Pietro Mascagni, James Levine, National Philharmonic Orchestra	Mascagni: Cavalleria Rusticana - The Sony Opera House	spotify:track:7zkHCFPDIRn31DRIiekNmh
Carmen Suite No. 2: Danse bohème. Andante quasi Allegretto (Act II)	Georges Bizet, Leonard Bernstein, New York Philharmonic	Bizet: Carmen Suites Nos. 1 & 2 - Grieg: Peer Gynt Suites Nos. 1 & 2	spotify:track:4UCtVOchcuKmQStOABdoyw
Má Vlast, JB1:112: 2. Vltava	Bedřich Smetana, Wiener Philharmoniker, Herbert von Karajan	Dvorák: Symphony No.9 , Op.95, B. 178 "From the New World" / Smetana: The Moldau	spotify:track:5P6ySmn4cxd3pF4BNeMOIG
Carmen Suite No. 1: Prélude. Andante moderato (Prelude to Act I)	Georges Bizet, Leonard Bernstein, New York Philharmonic	Bizet: Carmen Suites Nos. 1 & 2 - Grieg: Peer Gynt Suites Nos. 1 & 2	spotify:track:5y2ZgHdGtgM7HTiW0Mv2Tf
Carmen Suite No. 1: Aragonaise. Allegro vivo (Prelude to Act IV)	Georges Bizet, Leonard Bernstein, New York Philharmonic	Bizet: Carmen Suites Nos. 1 & 2 - Grieg: Peer Gynt Suites Nos. 1 & 2	spotify:track:2rRHTLFU1HMjlje3vB1Knb
Carmen Suite No. 1: Intermezzo. Andantino quasi Allegretto (Prelude to Act III)	Georges Bizet, Leonard Bernstein, New York Philharmonic	Bizet: Carmen Suites Nos. 1 & 2 - Grieg: Peer Gynt Suites Nos. 1 & 2	spotify:track:5lgeqYPqL3YyABQCPtDY41
Carmen Suite No. 1: Séguedille. Allegretto (Act I)	Georges Bizet, Leonard Bernstein, New York Philharmonic	Bizet: Carmen Suites Nos. 1 & 2 - Grieg: Peer Gynt Suites Nos. 1 & 2	spotify:track:5RbrAxYY8WcfRIXt2brJlc
Carmen Suite No. 1: Les Toréadors. Allegro giocoso (Introduction to Act I)	Georges Bizet, Leonard Bernstein, New York Philharmonic	Bizet: Carmen Suites Nos. 1 & 2 - Grieg: Peer Gynt Suites Nos. 1 & 2	spotify:track:2Ji40kaDBUuWa0WOPX23eH
Tchaikovsky: Symphony No. 6 in B Minor, Op. 74, "Pathétique": I. Adagio - Allegro non troppo	Pyotr Ilyich Tchaikovsky, San Francisco Symphony, Michael Tilson Thomas	Tchaikovsky: Symphony No. 6, "Pathétique"	spotify:track:2wWNmMMOswemaPGC5GboPO
Tchaikovsky: Symphony No. 6 in B Minor, Op. 74, "Pathétique": II. Allegro con grazia	Pyotr Ilyich Tchaikovsky, San Francisco Symphony, Michael Tilson Thomas	Tchaikovsky: Symphony No. 6, "Pathétique"	spotify:track:3fpoKN01KWxzLTZpSywWgH
Tchaikovsky: Symphony No. 6 in B Minor, Op. 74, "Pathétique": III. Allegro molto vivace	Pyotr Ilyich Tchaikovsky, San Francisco Symphony, Michael Tilson Thomas	Tchaikovsky: Symphony No. 6, "Pathétique"	spotify:track:33Rg8I0hZWA8bmW9qpm1tM
Tchaikovsky: Symphony No. 6 in B Minor, Op. 74, "Pathétique": IV. Finale - Adagio lamentoso - Andante	Pyotr Ilyich Tchaikovsky, San Francisco Symphony, Michael Tilson Thomas	Tchaikovsky: Symphony No. 6, "Pathétique"	spotify:track:7cxMnnTbGZwaLMfKVEA9dr
The Nutcracker, Op. 71: Act I Tableau II: The forest of fir trees in winter	Pyotr Ilyich Tchaikovsky, Bolshoi Theatre Children's Choir, Bolshoi Theatre Orchestra, Alexander Vedernikov	Tchaikovsky: Nutcracker (The)	spotify:track:5SkFhcxG27qlHUo2AFSZq6
Hänsel und Gretel, EHWV 93.3, Act II: Der kleine Sandmann bin ich (Live)	Engelbert Humperdinck, Annika Gerhards, Katrin Wundsam, Alexandra Steiner, Deutsches Symphonie-Orchester Berlin, Marek Janowski	Humperdinck: Hänsel und Gretel, EHWV 93.3 (Live)	spotify:track:1ENZK3u3fY58hS4GdACImp
Hänsel und Gretel, EHWV 93.3, Act II: Abends, will ich schlafen geh’n (Live)	Engelbert Humperdinck, Katrin Wundsam, Alexandra Steiner, Deutsches Symphonie-Orchester Berlin, Marek Janowski	Humperdinck: Hänsel und Gretel, EHWV 93.3 (Live)	spotify:track:6bfwExuglJgM5UhuKGiLrf
Hänsel und Gretel, EHWV 93.3, Act II: Traumpantomime (Live)	Engelbert Humperdinck, Deutsches Symphonie-Orchester Berlin, Marek Janowski	Humperdinck: Hänsel und Gretel, EHWV 93.3 (Live)	spotify:track:3TygbB8X6F0Q561gG5zNNS
Lohengrin, Act II Scene 4: Bridal Procession	Richard Wagner, Kören av Kungliga Operan, Royal Stockholm Philharmonic Orchestra, Leif Segerstam	Love & Marriage: Classical Music for Your Wedding	spotify:track:6B31dKi5MOe3b4txAqClbB
Lohengrin, WWV 75: Prelude To Act III	Richard Wagner, Wiener Philharmoniker, Karl Böhm	Wagner: Overtures and Preludes	spotify:track:4e5IlAPXk0tqlFe3RCcFUM
月亮代表我的心	Teresa Teng	BTB 鄧麗君15週年	spotify:track:3Srw8isgDzmYsgwDi4MtbD
Cosi fan tutte: Secondate, aurette amiche (N°9)	Wolfgang Amadeus Mozart, Johann Nepomuk Wendt, Ensemble à Vent Maurice Bourgue	Mozart : Les plus beaux airs d'opéra	spotify:track:5VQqtoYyDKToX8WrgtsHeK
Cell Therapy	Goodie Mob	Moonlight (Original Motion Picture Soundtrack)	spotify:track:7gKmcAoQG4trqrbtGd8DwX
The Spot	Nicholas Britell	Moonlight (Original Motion Picture Soundtrack)	spotify:track:4gxVrGdFlhWAdl6PVC1yBY
All Star	Smash Mouth	Astro Lounge	spotify:track:3cfOd4CMv2snFaKAnMdnvK
The Middle of the World	Nicholas Britell	Moonlight (Original Motion Picture Soundtrack)	spotify:track:5pn4wdFwix4qr5SlNyRw7W
S, Pt. 1	monom	Bye	spotify:track:6DXwGi1dNM7DhnqgPYTt9q
A Piece of Me	monom	A Piece of Me	spotify:track:6G5QMmRk4vRvnErre6nO55
H	monom	Bye	spotify:track:3opPklNBowDV2iMuDFk090
Poet and Peasant: Overture	Franz von Suppé, Detroit Symphony Orchestra, Paul Paray	Suppé: Overtures / Auber: The Bronze Horse, etc.	spotify:track:5K4Y4L6xffI9Zd4EbTxiiu
F	monom	Bye	spotify:track:3n8pT74mi1denNsVbI01BH
Fairy Fountain	Mikel, GameChops	Zelda & Chill	spotify:track:7fD72waADOZymEpuQfbiDE
Dark World	Mikel, GameChops	Zelda & Chill	spotify:track:4Ay6SgcMwGhwx82GGfmdEJ
Lost Woods	Mikel, GameChops	Zelda & Chill	spotify:track:1trkhhMYjfU6R8VFo43dnD
Song of Storms	Mikel, GameChops	Zelda & Chill	spotify:track:0c4KyvtJPmHd5mnXYE5QnZ
Gerudo Valley	Mikel, GameChops	Zelda & Chill	spotify:track:3fBa2iRjwXz5bt6WMAx1so
Dragon Roost Island	Mikel, GameChops	Zelda & Chill	spotify:track:6aDH3NhlyDOaQZnpdoZF9O
Ballad of the Goddess	Mikel, GameChops	Zelda & Chill	spotify:track:23fAKWcdPS7XwUTCtmWmTt
Legend of Zelda	Mikel, GameChops	Zelda & Chill	spotify:track:4Jx9h7JWhXZyMdbpwULXsP
Ocarina of Time	Mikel, GameChops	Zelda & Chill	spotify:track:4Q7ZTcOemrVx5ex3JHVPvn
Oh Nanana - Remix	dj 6rb, Bonde R300, xang, mayklove	Oh Nanana (Remix)	spotify:track:69PqVX29aZhDGFlG2SKxFy
Freedom Dive	XI	Parousia	spotify:track:1DUA8KW4Fes6qfSlNJqvwj
Aesthetic? (More Like Ass-Pathetic)	Panucci's Pizza	All The Toppings	spotify:track:2fTsxw433lT9uYnIH3ihDU
Swiggity Swooty (I'm Coming for That Booty)	YaBoyJdub	Swiggity Swooty (I'm Coming for That Booty)	spotify:track:1cfEszNrexj0mOOLi0CJwt
Internshit	Danny Dalah	Internshit	spotify:track:7CRl1XiJmeylpmm0MYHS6y
How to Pick a College Major	Danny Dalah	How to Pick a College Major	spotify:track:2nlJwgBVANp1N7R0S0CTOm
Bring Me Sunshine	The Jive Aces	Bring Me Sunshine	spotify:track:0tdV8Gsq1IDvmV3YUeagpR
Minnie The Moocher	Big Bad Voodoo Daddy	How Big Can You Get?: The Music Of Cab Calloway	spotify:track:0LFIogdKLhuH3y1Tf78EYW
The Exchange	Lorne Balfe	Mission: Impossible - Fallout (Music from the Motion Picture)	spotify:track:7JyDf9e1zyNePJ26XVChJ5
Fallout	Lorne Balfe	Mission: Impossible - Fallout (Music from the Motion Picture)	spotify:track:0llzwIl1LZHvOW2GIKJ3jQ
Still D.R.E.	Dr. Dre, Snoop Dogg	2001	spotify:track:503OTo2dSqe7qk76rgsbep
Come On Eileen	Dexys Midnight Runners	Too Rye Ay	spotify:track:0EMmVUYs9ZZRHtlADB88uz
Rude Boy	MAMAMOO	Yellow Flower	spotify:track:2xQDQkfWWFxx46y7ug6D6p
From "12 Etudes," Op. 39: Shadow Dance	Diane Hidy	MacDowell: Selected Works for Piano	spotify:track:1swfBKNIj4cKr0v0SjINvG
Nocturnes, Op. 9: No. 1 in B flat major. Larghetto	Frédéric Chopin, Brigitte Engerer	Chopin: Complete Nocturnes	spotify:track:4pTB18dbtjTTCLkybdylX6
Ni**as In Paris	JAY-Z, Kanye West	Top Five (Music From And Inspired By The Motion Picture)	spotify:track:2KpCpk6HjXXLb7nnXoXA5O
No Limit	G-Eazy, A$AP Rocky, Cardi B	No Limit	spotify:track:2Xqd0wUttjueBfdcltADOv
Street Fighter Mas	Kamasi Washington	Street Fighter Mas	spotify:track:4zcG9UC60lWbaKr1qj8WNP
Polovtsian Dances From "Prince Igor"	Alexander Borodin, Torgny Sporsen, Gothenburg Symphony Orchestra, Neeme Järvi, Gothenburg Symphony Chorus	Tchaikovsky: Overture "1812"; Marche slave / Borodin: In the Steppes; Polovtsian Dances / Rimsky-Korsakov: Russian Easter; Capriccio	spotify:track:0PlTjNRzj6MkPfaLHNeZLZ
Symphony No. 5 in C Minor Op. 67 - Allegro	Ludwig van Beethoven, Sinfonia Amabile, Piotr Wojrak	Beethoven: 5th Symphony	spotify:track:4y9joEoCTI0vOYCvHou9Hz
Symphony No. 5 in C Minor Op. 67 - Allegro Attacca	Ludwig van Beethoven, Sinfonia Amabile, Piotr Wojrak	Beethoven: 5th Symphony	spotify:track:6TSC7rBcBN2oEG0ObaY3mh
Symphony No. 5 in C Minor Op. 67 - Andante Con Moto	Ludwig van Beethoven, Sinfonia Amabile, Piotr Wojrak	Beethoven: 5th Symphony	spotify:track:0wWEJeKbkpVg7QCQVWlkIv
Symphony No. 5 in C Minor Op. 67 - Allegro Con Brio	Ludwig van Beethoven, Sinfonia Amabile, Piotr Wojrak	Beethoven: 5th Symphony	spotify:track:7voKL1C28xCP8reOKi77h5
Lucid Dreams	Juice WRLD	Goodbye & Good Riddance	spotify:track:0X8DcetL926BYiPJYstJTc
Symphony No. 6 In B Minor, Op. 74, TH.30: 4. Finale: Adagio lamentoso - Andante	Pyotr Ilyich Tchaikovsky, Czech Philharmonic Orchestra, Semyon Bychkov	Tchaikovsky: Symphony No.6 in B Minor - "Pathétique"; Romeo & Juliet Fantasy Overture	spotify:track:7LFs89i1kqjEzIvYR1WwJh
Serenade in E Major for Strings, Op. 22: II. Menuetto	Antonín Dvořák, Prague Chamber Orchestra	Dvořák: Serenade for Strings, Czech Suite	spotify:track:6HGzj1FMXVBAi2AtBCbhCQ
Dame Tu Cosita (feat. Cutty Ranks)	El Chombo, Cutty Ranks	Dame Tu Cosita (feat. Cutty Ranks)	spotify:track:09SNuR471zu5nVvC4IVG8j
heart	IU	heart	spotify:track:5ktwBE88NKZSfmk6Lw2KhS
Shooting Stars	Bag Raiders	Bag Raiders (Deluxe)	spotify:track:0UeYCHOETPfai02uskjJ3x
Wake Me Up	Avicii	True	spotify:track:4h8VwCb1MTGoLKueQ1WgbD
Sour Patch Kids	Bryce Vine	Lazy Fair	spotify:track:1Pyxh8ERS8aouSSOQVvVsz
Plain Jane	A$AP Ferg	Still Striving	spotify:track:4dVpf9jZjcORqGTLUaeYj9
Bonfire	Childish Gambino	Camp	spotify:track:4zGvb8hxGLB2jEPRFiRRqw
HandClap	Fitz and The Tantrums	Fitz and The Tantrums (Deluxe Edition)	spotify:track:4qRaZYiaOsSvWC7VgcxrI0
92 Explorer	Post Malone	beerbongs & bentleys	spotify:track:1D2L6MefbXon28PzIk9I3r
Peek-A-Boo	Red Velvet	Perfect Velvet - The 2nd Album	spotify:track:42tFTth2jcF7iSo0RBjfJF
Lift Yourself	Kanye West	Lift Yourself	spotify:track:3uYDO9dPLTVrgfwg7EYXSf
This Is America	Childish Gambino	This Is America	spotify:track:0b9oOr2ZgvyQu88wzixux9
Jaigantic (Galimatias Remix)	Tora, Galimatias	Jaigantic (Galimatias Remix)	spotify:track:098Krv08Lj9YlZShuq5564
Babuji Dhere Chalna (From "Aar Paar")	Geeta Dutt	Golden Era	spotify:track:7KXRheho5WSnweUitgFwo6
Instant crush (Spotify Session)	The Dø	Spotify Sessions	spotify:track:2cAQkQlaxMUaMIL69ge359
Instant Crush (feat. Julian Casablancas)	Daft Punk, Julian Casablancas	Random Access Memories	spotify:track:2cGxRwrMyEAp8dEbuZaVv6
Cello Concerto in B Minor, Op. 104, B. 191: II. Adagio ma non troppo	Antonín Dvořák, Mstislav Rostropovich, Berliner Philharmoniker, Herbert von Karajan	Dvorák: Cello Concerto / Tchaikovsky: Variations on a Rococo Theme	spotify:track:3Mm0CDO4UGGqP4eHIIZOgt
An American in Paris	George Gershwin, Columbia Symphony Orchestra, Leonard Bernstein, New York Philharmonic	Gershwin: Rhapsody in Blue & An American in Paris	spotify:track:7tMaOTu32tb7G2Ieb9ULY8
Sweater Weather - Live	Vitamin String Quartet	VSQ Live at Troubadour	spotify:track:2OF3KdQUsCHUPfuzhv470F
Oops!... I Did It Again	Scott Bradlee's Postmodern Jukebox, Haley Reinhart	Swipe Right For Vintage	spotify:track:3LoIBdxoJR1P61Gxytw1Mg
Sing, Sing, Sing	Benny Goodman	The Essential Benny Goodman	spotify:track:5L8ta4ECl5zeA6bGqY7G38
Best Friend	Rex Orange County	Best Friend	spotify:track:47Bg6IrMed1GPbxRgwH2aC
Season 2 Episode 3	Glass Animals	How To Be A Human Being	spotify:track:4vcoNCrTtunmJ9q8srpVly
2U	David Guetta, Justin Bieber	2U	spotify:track:762UXiwEHYY97VL45sAUPR
A Moment Apart	ODESZA	A Moment Apart	spotify:track:59wlTaYOL5tDUgXnbBQ3my
Aloha	Møme, Merryn Jeann	Panorama	spotify:track:7IfOWyh4jTfkcGVrXKVNq0
Candide: Overture	Leonard Bernstein, New York Philharmonic	Bernstein Conducts Bernstein	spotify:track:47r7pm0fWKmneTjjbVKlCW
Lovefool	Scott Bradlee's Postmodern Jukebox, Haley Reinhart	Swipe Right For Vintage	spotify:track:1MAIJFzQFIQ2Hkm3X5YtCW
Seven Nation Army	Scott Bradlee's Postmodern Jukebox, Haley Reinhart	Swipe Right For Vintage	spotify:track:2Lv9mFjcIFPn8zyWF89EAe
Killmonger	Ludwig Goransson	Black Panther (Original Score)	spotify:track:0w7yUSxpQV3a3HqlprOQUs
Ancestral Plane	Ludwig Goransson	Black Panther (Original Score)	spotify:track:4WpiAjBDThflXFd1ozGiF5
Royal Talon Fighter	Ludwig Goransson	Black Panther (Original Score)	spotify:track:73BchyYk3TJToQZ7xUmF48
Gaston - From "Beauty and the Beast" / Soundtrack Version	Richard White, Jesse Corti, Chorus - Beauty And the Beast	Beauty and the Beast	spotify:track:0zstgBrV1t1g6n4jHrUVBY
Gaston (Reprise) - From "Beauty and the Beast"/Soundtrack Version	Jesse Corti, Richard White	Beauty and the Beast	spotify:track:5okQdAL1mkI6PnHWQn5Abn
Be Our Guest - From "Beauty and the Beast"/Soundtrack	Angela Lansbury, Jerry Orbach, Chorus - Beauty And the Beast	Beauty and the Beast	spotify:track:6btdYzQ8eZFBrOlUKVHuz0
Woke The F*ck Up	Jon Bellion	The Human Condition	spotify:track:1zTW7xRtxmprjTUDi6bAHg
All Time Low	Jon Bellion	The Human Condition	spotify:track:0SuLAslEMFZAXf0SwY7syi
Mine	Bazzi	Mine	spotify:track:6tHWl8ows5JOZq9Yfaqn3M
Saint- Saëns: Introduction and Rondo Capriccioso, Op. 28	Camille Saint-Saëns, Min Kym	Gone	spotify:track:4zwqGZonPVbo2fxcN3467v
Blackbird - Remastered 2009	The Beatles	The Beatles (Remastered)	spotify:track:5jgFfDIR6FR0gvlA56Nakr
Dvorák: Cello Concerto in B Minor, Op. 104, B. 191: III. Finale (Allegro moderato)	Antonín Dvořák, Jacqueline du Pré, Daniel Barenboim, Chicago Symphony Orchestra	The Heart of the Cello	spotify:track:4D1eRjMEBCRgSn6Xnpx5V1
House of Cards (Full Length Edition)	BTS	The Most Beautiful Moment in Life: Young Forever	spotify:track:4BMbbfwW9GLl9b05ecYKVa
Save Me	BTS	The Most Beautiful Moment in Life: Young Forever	spotify:track:54s6sdPuMjVtdB5d5KFzTC
Stitches	Shawn Mendes	Handwritten	spotify:track:5jsw9uXEGuKyJzs0boZ1bT
There's Nothing Holdin' Me Back	Shawn Mendes	Illuminate (Deluxe)	spotify:track:7JJmb5XwzOO8jgpou264Ml
Peer Gynt Suite No. 1, Op. 46: IV. In the Hall of the Mountain King. Alla marcia e molto marcato	Edvard Grieg, Leonard Bernstein, New York Philharmonic	Bizet: Carmen Suites Nos. 1 & 2 - Grieg: Peer Gynt Suites Nos. 1 & 2	spotify:track:3JCKvcwwjdMFzKBEf124q6
Carmen Suite No. 2: Habanera. Allegretto quasi Andantino (Act I)	Georges Bizet, Leonard Bernstein, New York Philharmonic	Bizet: Carmen Suites Nos. 1 & 2 - Grieg: Peer Gynt Suites Nos. 1 & 2	spotify:track:279aYcgTTMetBKyMdlCJFN
Finale	John Williams	Star Wars: The Last Jedi (Original Motion Picture Soundtrack)	spotify:track:3pVqoWOgMuI1K4p4oKheGh
I Know What You Did Last Summer	Shawn Mendes, Camila Cabello	Handwritten	spotify:track:2GyA33q5rti5IxkMQemRDH
Afterlife (Remix by Frank Pole)	Frank Pole, Greyson Chance	Afterlife	spotify:track:2sLOxiEuoHX49R7bHcqQcR
Meridians	Greyson Chance	Meridians	spotify:track:6tbJTYiaeBjjkZBF1nIGgw
Ahch-To Island	John Williams	Star Wars: The Last Jedi (Original Motion Picture Soundtrack)	spotify:track:1FFYCAWFz9drun5Br4w5Kk
Rey's Theme	John Williams	Star Wars: The Force Awakens (Original Motion Picture Soundtrack)	spotify:track:3IRYrM9MVI79zHkWoiulnV
Passion	Colton Weatherston, Dave Bennett, Evan Peri, Julien Labro, Paul Brady, Shannon Wade	Hot Club Of Detroit	spotify:track:69iAZmuf31C1sMBMYBJDbn
Aurore	Colton Weatherston, Dave Bennett, Evan Peri, Julien Labro, Paul Brady, Shannon Wade	Hot Club Of Detroit	spotify:track:0Bi9He61bBP8aF17bUYABY
Floresta do Amazonas: Melodia Sentimental (Sentimental Melody) (arr. J. Labro for accordina and string quartet)	Heitor Villa-Lobos, Julien Labro, Spektral Quartet	From This Point Forward	spotify:track:5UcuX0FBCj15Iydt21dbPM
Duel Of The Fates	London Voices, London Symphony Orchestra, John Williams, New London Children's Choir	Star Wars: The Phantom Menace (Original Motion Picture Soundtrack)	spotify:track:7di1zbwgfJkRLkTGV44icu
Milonga loca (arr. J. Labro for bandoneon and string quartet)	Astor Piazzolla, Julien Labro, Spektral Quartet	From This Point Forward	spotify:track:5UIvMUu2Hg8dJRim1iaIr2
Let It Snow! Let It Snow! Let It Snow! (with The B. Swanson Quartet)	Frank Sinatra, B. Swanson Quartet	Christmas Songs By Sinatra	spotify:track:7inXu0Eaeg02VsM8kHNvzM
Drop The Game	Flume, Chet Faker	Lockjaw	spotify:track:150zGw0P2EJccYJKnFIler
WHISTLE	BLACKPINK	SQUARE ONE	spotify:track:7HWmJ1wBecOAMNGjC6SmKE
Phone	Mickey Singh, UpsideDown	Phone	spotify:track:6MRuNaMaH65vGyek33fXMV
Senjitaley	Anirudh Ravichander	Remo (Original Motion Picture Soundtrack)	spotify:track:2RB3zzgxWc2RRBaJOkSEka
The Eye	INFINITE	INFINITE ONLY	spotify:track:78f6Qp6XQhSnJksCseLMMb
I Like Me Better	Lauv	I Like Me Better	spotify:track:1wjzFQodRWrPcQ0AnYnvQ9
Shut Up & Groove (feat. DEAN) [From And July]	HEIZE	Shut Up & Groove (feat. DEAN) [From And July]	spotify:track:1qz2bFE5ZtwZSd6DNed2RJ
String Quartet No. 8 in C Minor, Op. 110: II. Allegro molto	Dmitri Shostakovich, Altius Quartet	Shostakovich: String Quartets Nos. 7, 8 & 9	spotify:track:0K3DKujaZzjxxHpGzZIVw5
Havana (feat. Young Thug)	Camila Cabello, Young Thug	Havana (feat. Young Thug)	spotify:track:0ofbQMrRDsUaVKq2mGLEAb
La cumparsita	Juan D'Arienzo	La cumparsita - 15 versiones - 15 grandes orquestas	spotify:track:3fwzg6iqsM3IW2BALd8UBy
Trndsttr (feat. M. Maggie) - Lucian Remix	Black Coast, M. Maggie, Lucian	Trndsttr (feat. M. Maggie) [Lucian Remix]	spotify:track:5LZQ5s0kRZS9nBSd1xLK7U
Zen Ball Master	John Powell, Hans Zimmer	Kung Fu Panda 2 (Music From The Motion Picture)	spotify:track:2w7lx0AX0CtNE5JrZXrGIu
Night on Bald Mountain	Modest Mussorgsky, Leonard Bernstein, New York Philharmonic	Mussorgsky: Pictures at an Exhibition, Night on Bald Mountain & Songs and Dances of Death	spotify:track:12pe2mL5SQGMI1gBGcEWKE
Symphonie fantastique, Op. 14: Symphonie fantastique, Op. 14: IV. Marche au supplice	Hector Berlioz, Swedish Radio Symphony Orchestra, Daniel Harding	Berlioz: Symphonie Fantastique - Rameau: Suite de Hippolyte et Aricie	spotify:track:1SHixA41Vy0TTlJJSX9Gbo
Peer Gynt Suite No. 1, Op. 46 : IV. In the Hall of the Mountain King	Edvard Grieg, English Chamber Orchestra, Raymond Leppard	Grieg - Classical Masterpieces	spotify:track:1Qobrq16ZUdAJfjrkKHb2u
Stuff We Did	Michael Giacchino	Up (Original Motion Picture Soundtrack)	spotify:track:19blFYzqmPj7FtW7W4DFEl
Seven Nation Army	The White Stripes	Elephant	spotify:track:7i6r9KotUPQg3ozKKgEPIN
Vivir Mi Vida	Marc Anthony	3.0	spotify:track:3QHMxEOAGD51PDlbFPHLyJ
Beethoven: Symphony No. 9 in D Minor, Op. 125 "Choral": III. Adagio molto e cantabile - Andante moderato	Ludwig van Beethoven, Nikolaus Harnoncourt, Chamber Orchestra of Europe	Beethoven : Symphonies Nos 1 - 9	spotify:track:4pAD2i8zVtSPCcV7RYPFVc
Take A Hint	Victorious Cast, Victoria Justice, Elizabeth Gillies	Victorious 2.0: More Music From The Hit TV Show	spotify:track:1T20tqHKrePjszGOdbFOEd
Portal 2 - Cara Mia Addio	Vitamin String Quartet	Geek Wedding, Vol. 2: The Sequel	spotify:track:6IwsYn1LXgnxZCLFmos5sw
Howl's Moving Castle - Merry-Go-Round of Life	Vitamin String Quartet	Geek Wedding, Vol. 2: The Sequel	spotify:track:20nMssNxX89e7YMoT0gpFQ
I'm Yours	Jason Mraz	We Sing. We Dance. We Steal Things.	spotify:track:1EzrEOXmMH3G43AXT1y7pA
Salope !	Bigflo & Oli	La vraie vie	spotify:track:1r2NHXytZEg1hsmy9pikgR
1-800-273-8255	Logic, Alessia Cara, Khalid	Everybody	spotify:track:5tz69p7tJuGPeMGwNTxYuV
Personne	Bigflo & Oli	La vraie vie	spotify:track:5fOy1jT3t2l4wgNQHPwcMz
Theme From New York, New York	Frank Sinatra	Ultimate Sinatra	spotify:track:4ODWgs1CVAZKDbryEodjiz
Come Fly With Me - Remastered	Frank Sinatra	Come Fly With Me (Remastered)	spotify:track:4hHbeIIKO5Y5uLyIEbY9Gn
Symphony No. 5 in C Minor, Op. 67: II. Andante con moto	Ludwig van Beethoven, Simón Bolívar Symphony Orchestra Of Venezuela, Gustavo Dudamel	Beethoven 5 - Dudamel	spotify:track:0nwEolVieux9Mo1F4a4kel
Worth It (feat. Kid Ink)	Fifth Harmony, Kid Ink	Reflection (Deluxe)	spotify:track:41Fflg7qHiVOD6dEPvsCzO
The Way I Do	Bishop Briggs	Bishop Briggs	spotify:track:4HXmYG1IR5xduvxTnr7fAp
River	Bishop Briggs	Bishop Briggs	spotify:track:0TGTE9TEh9qzuFwmtRNICn
Dark Side	Bishop Briggs	Bishop Briggs	spotify:track:6FFrva3VXMwabDvuHkX4ZU
Wanna Be Cool	Donnie Trumpet & The Social Experiment	Surf	spotify:track:4Zf351SuPuXo8w6IIMsxev
Jenova (FINAL Fantasy Vii)	Nobuo Uematsu	Distant Worlds II: more music from Final Fantasy	spotify:track:7qQbQHcQQCKA0kuqBPLjzL
Ronfaure (FINAL Fantasy Xi)	Nobuo Uematsu	Distant Worlds II: more music from Final Fantasy	spotify:track:7hiALMwjWvaaf93yU6LeX0
Aerith's Theme (Final Fantasy VII)	Nobuo Uematsu	Distant Worlds: music from Final Fantasy	spotify:track:610EDOFqHM0HLGu5x0QDOH
Final Fantasy X (Piano Concerto): I. Zanarkand	Nobuo Uematsu, Masashi Hamauzu, London Symphony Orchestra, Katharina Treutler, Eckehard Stier	Final Symphony - Music From Final Fantasy VI, VII and X	spotify:track:3LeLEZCHjaKuCIOuz8XFcT
Rewind	Louis Futon, Ashe, Armani White	Rewind	spotify:track:5FAK7GY5W3PUBPLkJ6R2wq
Say Something	Vitamin String Quartet	VSQ Performs the Hits of 2014, Vol. 1	spotify:track:3lDVrC13oxt1IMvBbqT1Es
Don't Think Twice, It's All Right	Leftover Cuties	Departures	spotify:track:7MlkFsiVisUzkZTjszxY0e
Maple Leaf Rag	Scott Joplin, Joshua Rifkin	Scott Joplin Piano Rags	spotify:track:5cO1oGqX8S2w96CwISPlLE
The Entertainer	Scott Joplin, Morten Gunnar Larsen	Fingerbreaker: Classics Of Ragtime And Early Jazz Piano	spotify:track:6DWIm1TfM9WiCNQeLbbAsd
Maple Leaf Rag	Scott Joplin, Alexander Peskanov	Joplin: Piano Rags, Vol. 1	spotify:track:4AE032Y0x1WPOi5CsmggnU
Entirety	Bon Vie	Entirety	spotify:track:3nvpVuUE9mO7fvFI6E9WYY
Endless Fragments of Time	Deep Watch	Endless Fragments of Time	spotify:track:1UFmSqbxVtP5pl9r8KdeY1
Moments	Deep Watch	Endless Fragments of Time	spotify:track:5C8szoUrtmYOizu1ykbK0C
Cycles	Methal, X Ambassadors	Cycles	spotify:track:0KTljCpQ0qNv2Zev3dAxMM
Justify You	Kasra V, K.Flay	Justify You	spotify:track:1KzpQpEQm7DVEP6P1gAkh9
Location	Khalid	American Teen	spotify:track:152lZdxL1OR0ZMW6KquMif
Mack the Knife	Louis Armstrong	I Like Jazz: The Essence Of Louis Armstrong	spotify:track:55B21E0EUDR2ulqZihVEp9
Saved	Khalid	American Teen	spotify:track:248OFOZef6ShXv6DGgbnxU
Zanarkand (FINAL Fantasy X)	Nobuo Uematsu	Distant Worlds II: more music from Final Fantasy	spotify:track:7cbBZqBwEzlKBIYPb1Cbf0
Symphony In D Minor: 1. Lento - Allegro ma non troppo - Allegro	César Franck, Deutsches Symphonie-Orchester Berlin, Lorin Maazel	Franck: Symphony in D minor / Mendelssohn: Symphony No.5	spotify:track:2FuXzw3411PvkVCUPosF30
Budapest	George Ezra	Did You Hear the Rain?	spotify:track:48gsLPdOUEDjr7P8Wvykne
Cambridge, 1963	Jóhann Jóhannsson	The Theory of Everything (Original Motion Picture Soundtrack)	spotify:track:6Inmo6ElDCaiZCiB6lficH
Bériot: Scène de ballet, Op. 100	Charles-Auguste de Bériot, Itzhak Perlman, Lawrence Foster, The Juilliard Orchestra	Concertos From My Childhood	spotify:track:665ubk37bv9DkUu4OGT7F5
Thunderstruck	2CELLOS	Thunderstruck	spotify:track:02n2IYAPuVKrqZfNuBqPMW
I Need A Dollar	Aloe Blacc	I Need A Dollar 12"	spotify:track:19KlLuxA7AxvQpoQYx7zhG
Hey There Delilah	Plain White T's	Hey There Delilah	spotify:track:1NarGDteHRuDA9OfGyQ2MG
The Lion Sleeps Tonight (Wimoweh)	The Tokens	Wimoweh!!! - The Best Of The Tokens	spotify:track:2F4FNcz68howQWD4zaGJSi
Home	Vitamin String Quartet	The Modern Wedding Collection, Vol. 2	spotify:track:0S9rI5FAXcVFe3ov2wMrNd
You Make Me	Avicii	True	spotify:track:1CKtxKqyFsFITCH4SpDrWj
Rather Be	Vitamin String Quartet	VSQ Performs the Hits of 2014, Vol. 3	spotify:track:1J1Avc7J6jj2Dxvy7jmTUq
Love Me Again	The Muses	Pop on Strings, Vol. 3	spotify:track:1iYHzNeSuOPej1ir0i7fyy
Secrets	Simply Three	Simply Three	spotify:track:0seiO4g7grz4BSwhTLGFWU
We Are the Champions	Vitamin String Quartet	Vitamin String Quartet Performs Queen	spotify:track:1HZmYMxGZ3nPEIUhhiZoj6
I Will Wait	Mumford & Sons	Babel	spotify:track:2JHBMVs8E7bJJBLkXpKgHn
Riptide - Live from Spotify SXSW 2014	Vance Joy	Spotify Sessions	spotify:track:0f5EFbO028n3VyTgHlS0lo
Shots	Vitamin String Quartet	VSQ Performs Imagine Dragons	spotify:track:0kJ2J07FhpzUlS1ehr8BkV
Little Lion Man	Vitamin String Quartet	VSQ Performs Modern Rock Hits 2010	spotify:track:0yFTQsPgKgg9lWhGQnRfcD
The Walker	Vitamin String Quartet	VSQ Performs the Hits of 2014, Vol. 2	spotify:track:1Q6lbJNHVJoiYhTYmYVP7G
When The Darkness Comes	Colbie Caillat	The Mortal Instruments: City of Bones (Original Motion Picture Soundtrack)	spotify:track:1BOtiZR5OTg7e4nHFlI3p4
Good Time	Owl City, Carly Rae Jepsen	The Midsummer Station	spotify:track:1kPpge9JDLpcj15qgrPbYX
Little Lion Man	Mumford & Sons	Sigh No More	spotify:track:2BBkIgdXLv5vyp1DR0wpQl
Hungarian Dance No. 5 in G minor - Orchestrated by Iván Fischer	Johannes Brahms, Iván Fischer, Budapest Festival Orchestra	Brahms - The Greatest Performances	spotify:track:11DeoxCB37YazNIhP6pke7
Passacaglia für Violine und Bratsche Frei nach Händel	Johan Halvorsen, Elise Båtnes, Henninge Båtnes Landaas, Henninge Landaas	Mozart - Halvorsen - Brustad , Violin and Viola Duos	spotify:track:1Ct5zwNzprlBy6ystbYaaV
A Hero's Welcome	Takénobu	Momotaro	spotify:track:1qzcameK5km1q08vE83rCz
42 Etudes: No.13, Moderato	Rodolphe Kreuter, Masayuki Kino	Kreutzer: 42 Etudes	spotify:track:28a0xciNRAuX6XBlIzBF5Q
Coming Home - Part II / Bonus Track	Skylar Grey	Don't Look Down	spotify:track:2EowclmjcHVK6W8xlngurh
Cielito Lindo	Mariachi Mexico	Mariachi Mexico	spotify:track:1lPtXhYYgqrr9Kjp08foa1
String Quartet No. 3 (Mishima): Mishima / Closing	Philip Glass, Kronos Quartet	Kronos Quartet Performs Philip Glass	spotify:track:23E6uT0zTJrY1xZlhDjh8m
From Within	PostHaste Music	PHM Presents: Best of Mark Petrie	spotify:track:20hX70aeVgiiaGJlMP8Rv4
Sonata No. 2 in B Minor for Piano, Op. 35: Funeral March	Henrik Måwe	Best - Chopin	spotify:track:1NFXWoO3ZIHIxRnibNng1w
Symphony No. 3 in F Major, Op. 90: III. Poco allegretto	Johannes Brahms, Boston Symphony Orchestra, Bernard Haitink	Brahms - The Greatest Performances	spotify:track:0hKKO8CzCBXt0DvEYGBJgg
La Luz	Juanes	La Luz	spotify:track:2TGJBYnmNyoUqXuEA1FzxD
This Love	Simply Three	Simply Three	spotify:track:2cjFXfDKcGYEZMtPsb3Ppt
Rather Be (feat. Jess Glynne)	Clean Bandit, Jess Glynne	Rather Be (feat. Jess Glynne)	spotify:track:3s4U7OHV7gnj42VV72eSZ6
Hey Brother	Vitamin String Quartet	VSQ Performs the Hits of 2014, Vol. 1	spotify:track:3ySHMLqglFNiX5gtQGQnjX
Dare (La La La)	Shakira	Shakira.	spotify:track:47VueTChrhOjNaJTOzaskN
Unaccompanied Cello Suite No. 1 in G Major: Prelude	Steven Sharp Nelson	Sacred Cello	spotify:track:49yMnTwiMc9OFcFMKsFNpn
Rolling in the Deep	Vitamin String Quartet	VSQ Performs Adele	spotify:track:4OCRAoH6XZkszgqwTPacnP
Centuries	Vitamin String Quartet	VSQ Performs the Hits of 2014, Vol. 3	spotify:track:4tQiCpQ3aQjBhEG9vBO6rU
Love Me Again	John Newman	Love Me Again	spotify:track:57PjISfyOyDcvTPipz16nf
Everybody Talks	Neon Trees	Everybody Talks	spotify:track:5JGxJFdgOQdJZdmyEzDtTj
Fade Into Darkness - Vocal Radio Mix	Avicii	Fade Into Darkness	spotify:track:5cxVSooSqpQ1IbVcC1nNT4
Bohemian Rhapsody	Vitamin String Quartet	Vitamin String Quartet Performs Queen	spotify:track:3KuuzvDu9YEFANLMcmdZuC
I Bet My Life	Vitamin String Quartet	VSQ Performs Imagine Dragons	spotify:track:3aT5qYoZyzlWsnG1EgkMD4
Ho Hey	Vitamin String Quartet	VSQ Performs Modern Rock Hits 2012 Vol. 1	spotify:track:438NlmuC0Be4zqU89KrWUP
Divenire	Ludovico Einaudi	Divenire	spotify:track:4O0Yww5OIWyfBvWn6xN3CM
Can't Remember to Forget You	Shakira, Rihanna	Shakira. (Deluxe Version)	spotify:track:4Uc6BcPeBKfZUlX6jhumGv
Sonata No. 2 in B Minor for Piano, Op. 35: III. Funeral March: Lento	Frédéric Chopin, Vitaly Margulis	Chopin	spotify:track:4s39l4tubtusBuGLfbkMPi
Happy	Vitamin String Quartet	VSQ Performs the Hits of 2014, Vol. 1	spotify:track:5LE0GyCAZFdVvPKqkCc0gH
Blue (From the 'Photos Every Day' TV Advert)	L'Orchestra Cinematique	Red, Blue and Green - Music from the 'Every Day' TV Adverts	spotify:track:5Po4D92xN38cx5I8Lj3YpM
Let Me Take You To Rio - Blu's Arrival	Ester Dean, Carlinhos Brown	Rio: Music From The Motion Picture (International Version)	spotify:track:5Uyll1hHH9KpAVkMC4pGDy
Demons	Vitamin String Quartet	VSQ Performs Imagine Dragons	spotify:track:2WlAKY2aMPHoriLnhUxUvy
Rolling in the Deep - Live	Vitamin String Quartet	VSQ Live at Troubadour	spotify:track:2bMsJl2vfuo8dmcaqurik8
Blank Space	Vitamin String Quartet	VSQ Performs the Hits of 2014, Vol. 3	spotify:track:3jIIsSXGcrzWAYfKYgv0Dk
Me And My Broken Heart	Rixton	Me And My Broken Heart	spotify:track:41Ypl7Pzkod2H0VlcZH5DS
Crystallize	Lindsey Stirling	Lindsey Stirling	spotify:track:5JFkuKQsPps2ZaZzaLx63d
Green (From the 'Face Time Every Day' TV Advert)	L'Orchestra Cinematique	Red, Blue and Green - Music from the 'Every Day' TV Adverts	spotify:track:5KGh4bpGwspdshBk97qiq7
I’m So Sorry	Imagine Dragons	Smoke + Mirrors	spotify:track:4o74y4XY1ypNZkZtZkK8Wi
Everybody Talks	Vitamin String Quartet	VSQ Performs The Hits of 2012, Vol.1	spotify:track:2JljKhlukLr2oRTrXDTVcF
Lovers In Japan	Vitamin String Quartet	Vitamin String Quartet Performs Coldplay's Viva La Vida	spotify:track:4VORn1Ec643DiJtZ8GqdU6
I Gotta Feeling	Black Eyed Peas	THE E.N.D. (THE ENERGY NEVER DIES)	spotify:track:4vp2J1l5RD4gMZwGFLfRAu
Ho Hey	The Lumineers	The Lumineers	spotify:track:5BSndweF91KDqyxANsZcQH
Ain't It Fun	Vitamin String Quartet	VSQ Performs the Hits of 2014, Vol. 2	spotify:track:2rzZ65QRynPGpZbMR6d44e
The New Lobby Boy	Alexandre Desplat	The Grand Budapest Hotel (Original Soundtrack)	spotify:track:36vACHS1iPv2oGJ3rBH6ju
It's Time	Vitamin String Quartet	VSQ Performs Imagine Dragons	spotify:track:5hpa5Woo3hzipxsCOrka4C
Viva La Vida	Simply Three	Simply Three	spotify:track:2VU3rVNlSx0L8HpHLiy8hh
Take a Walk	Vitamin String Quartet	VSQ Performs Modern Rock Hits 2012, Vol. 2	spotify:track:2o6J75h705wbQrzDcnIRFC
Radioactive	Vitamin String Quartet	VSQ Performs Imagine Dragons	spotify:track:4HLiniDKSI1exymWTgrd3B
All About That Bass	Vitamin String Quartet	VSQ Performs the Hits of 2014, Vol. 3	spotify:track:5trbrSriHEao0z58afZfoE
A quai	Yann Tiersen	Amelie from Montmartre	spotify:track:5XmfF2AadD7CBS4v3sAL4U
Samson et Dalila : Bacchanale	Camille Saint-Saëns, Daniel Barenboim, Orchestre de Paris	#nowplaying Saint-Saens	spotify:track:3hVbKIgpyqFFBdsrbvElBu
Lego House	Ed Sheeran	+	spotify:track:53Pgsvu3qSYO2aXt5J2vcL
Bach, JS: Concerto for Two Violins in D Minor, BWV 1043: I. Vivace	Johann Sebastian Bach, Itzhak Perlman, Pinchas Zukerman, English Chamber Orchestra, Daniel Barenboim	Bach: Violin Concertos etc	spotify:track:3hPIrDZgNRsxpY84w4ruym
Island in the Sun	Vitamin String Quartet	Geek Wedding Collection	spotify:track:4Y77849I1eXWCwtN4AhxO0
I Want To Hold Your Hand	Vitamin String Quartet	VSQ Performs The Beatles, Vol. 2	spotify:track:51qacgJaLMHh8sTwWTDTdq
Hallelujah - Live	Vitamin String Quartet	VSQ Live at Troubadour	spotify:track:5XiKPeNfTddGiTnJRL14jB
Timber (feat. Ke$ha)	Pitbull, Kesha	Global Warming: Meltdown (Deluxe Version)	spotify:track:3cHyrEgdyYRjgJKSOiOtcS
Papa Georges Made Movies	Howard Shore	Hugo Original Score	spotify:track:5u1RdywwZMEHEmQyjhMu5h
Coeur Volant (feat. Zaz)	Howard Shore, Zaz	Hugo Original Score	spotify:track:5qXRNuSiF0jWKBJSVZ557k
The War (Zero's Theme)	Alexandre Desplat	The Grand Budapest Hotel (Original Soundtrack)	spotify:track:3YQW2tdTlNUaaGPZi0Svxb
Serenade (Arranged by Franz Liszt)	Franz Schubert, Sergei Rachmaninoff	Rachmaninoff Plays the Classics: Featuring Works By Bach, Mozart, Beethoven and More	spotify:track:4saJrhLW0Hc1lAteDZwsnr
I Want to Hold Your Hand	The Beatles Recovered Band	30 Beatles Top Hits	spotify:track:5uqlDIAv2oIC18IdrKuHCE
Hooked on a Feeling	Blue Swede, Björn Skifs	Hooked On A Feeling	spotify:track:6Ac4NVYYl2U73QiTt11ZKd
Sing (feat. Jeff Smith)	Simply Three, Jeff Smith	Sing (feat. Jeff Smith)	spotify:track:6C5MpTe0Ww0SzGKj0R3dwO
Skyfall	Vitamin String Quartet	Vitamin String Quartet Performs Adele's Skyfall	spotify:track:6cQkcWeJ5WGp96vex03L6e
Sing	Ed Sheeran	Sing	spotify:track:6eLrCtqlpjroAkES2EHCx0
Wake Me Up	Simply Three	Wake Me Up	spotify:track:6g6674CqGS1wmKjYM67Sac
Attaboy	Yo-Yo Ma, Stuart Duncan, Edgar Meyer, Chris Thile	The Goat Rodeo Sessions	spotify:track:6ghXD44kT8wqM1hty9NGgO
FOUND	Jun Sung Ahn	Found	spotify:track:6jzvv8PSYyPv8BGCXWeD5V
Keep Your Head Up	Andy Grammer	Andy Grammer	spotify:track:7MapZTlRqFfUteNcghsTwf
On Top of the World	Vitamin String Quartet	VSQ Performs Imagine Dragons	spotify:track:7MvANPtbtn3p9aOxUViMYS
Cello Concerto in E Minor, Op. 85: I. Adagio - Moderato	Edward Elgar, Sol Gabetta, Mario Venzago	Elgar: Cello Concerto/Dvorak/Respighi	spotify:track:7lBzTqUVUsjqBBD7eb8tNz
Red (From the 'Music Every Day' TV Advert)	Rob Simonsen, L'Orchestra Cinematique	Red, Blue and Green - Music from the 'Every Day' TV Adverts	spotify:track:7svtWa11rj5inAX55q33QJ
This Love	Maroon 5	Songs About Jane	spotify:track:6YgV0EF8xJMZz0Zm6BTaT4
Let Me Take You To Rio - Blu's Arrival	Ester Dean, Carlinhos Brown	Rio: Music From The Motion Picture	spotify:track:6ihp6Y28KwbBRg1XMvTFSz
Ex's & Oh's	Elle King	Love Stuff	spotify:track:70eDxAyAraNTiD6lx2ZEnH
Somewhere Only We Know	Simply Three	Two Worlds Collide	spotify:track:6Outxcyvr7UAbCACJ0g3AZ
Sing	Vitamin String Quartet	VSQ Performs the Hits of 2014, Vol. 2	spotify:track:6pNbGXAsWpSQZFgRMlXwB9
I'm Yours	Vitamin String Quartet	The Modern Wedding Collection, Vol. 2	spotify:track:7sN23y0QBZktcRVsVYQkIV
Riptide	Vance Joy	Dream Your Life Away	spotify:track:7yq4Qj7cqayVTp3FF9CWbm
I'm Yours	Simply Three	Simply Three	spotify:track:5wM6qaJqhURd3viiP1VMxK
Warriors	Vitamin String Quartet	VSQ Performs Imagine Dragons	spotify:track:7ERzVevRyjddivSkXo3loF
Home	Edward Sharpe & The Magnetic Zeros	Up From Below	spotify:track:6ZapsNk1ZpaebNXAIohP9R
I Wanna Hold Your Hand	Simply Three	Simply Three	spotify:track:7yFRpuRiUoDRaCkoAX2ysg
Fly Me To The Moon - 2008 Remastered	Frank Sinatra, Count Basie	Nothing But The Best (Remastered)	spotify:track:7FXj7Qg3YorUxdrzvrcY25
Best Day of My Life	Vitamin String Quartet	VSQ Performs the Hits of 2014, Vol. 1	spotify:track:7b7GnZPhVPkgiZbk6wIwIs
Riptide	Vitamin String Quartet	VSQ Performs the Hits of 2014, Vol. 3	spotify:track:7dEjQAnaMlb1oikHOXaTUO
Somethin' Stupid - 2008 Remastered	Frank Sinatra, Nancy Sinatra	Nothing But The Best (Remastered)	spotify:track:6wdWtY9TSHJkJcqrZYXszh
Piano Sonata No. 8 in A Minor, K. 310: I. Allegro maestoso	Wolfgang Amadeus Mozart, Denis Matthews, Hans Swarowsky, Vienna State Opera Orchestra	50 Classical Music Pieces to Make You Clever	spotify:track:6hmXAIWcixCOqBJyZLiSnt
Piano Sonata No. 8 in A Minor, K. 310: I. Allegro maestoso	Wolfgang Amadeus Mozart, Lang Lang	The Mozart Album	spotify:track:6FTwkH1NKJy8azszFM0iAZ
Le Festin	Camille, Michael Giacchino	Ratatouille (Original Motion Picture Soundtrack)	spotify:track:02JIdsrod3BYucThfUFDUX
Mr Selfridge Theme	L'Orchestra Cinematique	Mr Selfridge Theme	spotify:track:0HvGxA29etP329vurgMptM
Demons	Simply Three	Demons	spotify:track:0P3lxPKNkUyuyijWlBOoUF
Cello Suite No. 1 in G Major, BWV 1007: I. Prélude	Johann Sebastian Bach, Yo-Yo Ma	Bach: Cello Suites Nos. 1, 5 & 6	spotify:track:17i5jLpzndlQhbS4SrTd0B
Fix You / Clocks	Simply Three	Fix You / Clocks	spotify:track:1fS2yk5nXDFyYILKwp7m1l
Little Talks	Vitamin String Quartet	VSQ Performs The Hits of 2012, Vol.1	spotify:track:0lYVm6zosuZ6YFS9r1MopT
Secrets	OneRepublic	Waking Up	spotify:track:1NhPKVLsHhFUHIOZ32QnS2
Chopin: Prelude No. 4 in E Minor, Op. 28 No. 4 (Arr. for cello)	Frédéric Chopin, Julian Lloyd Webber	Unexpected Songs	spotify:track:0rkb7Foq2r3thp6xkDyMP6
Let It Go - From "Frozen"/Soundtrack Version	Idina Menzel	Frozen (Original Motion Picture Soundtrack / Deluxe Edition)	spotify:track:0qcr5FMsEO85NAQjrlDRKo
A Thousand Years	Christina Perri	The Twilight Saga: Breaking Dawn - Part 1 (Original Motion Picture Soundtrack)	spotify:track:1QUpqu8865jfasDr8M3IKN
String Quartet No. 2 in E Major, Op. 10: III. Vivace ma non troppo	Max Bruch, Academica String Quartet	Bruch: String Quartets Nos. 1 and 2	spotify:track:0K642NuObdTNPayZJZk1VV
Forbidden Friendship	John Powell	How To Train Your Dragon (Music From The Motion Picture)	spotify:track:0S7XIu0dn63ayGxjefd5It
Someone Like You	Instrumental Pop Players	Tribute to Adele: Piano Pop Songs	spotify:track:0pFldXOsLpXJB9OXEKaw08
The Fresh Prince of Bel-Air	DJ Jazzy Jeff & The Fresh Prince	Greatest Hits	spotify:track:0UREO3QWbXJW3gOUXpK1am
Finale (William Tell Overture)	Hans Zimmer	The Lone Ranger	spotify:track:0txFKLplUPPpb0YqR8x9lg
See You...	Claude Lamothe	Vivace	spotify:track:1fvEVbQIwvJsC9pHyiju49
Burn	Ellie Goulding	Halcyon Days	spotify:track:0xMd5bcWTbyXS7wPrBtZA6
Coming Back Around	John Powell	How To Train Your Dragon (Music From The Motion Picture)	spotify:track:0prLNHPLzTyroOlmWjyluS
Theme (From "Downton Abbey")	John Lunn, The City of Prague Philharmonic Orchestra	100 Greatest Classical Pieces	spotify:track:0ydGP75crLQZOYNdfwfuN9
The Time Of Your Life - From "A Bug's Life"	Randy Newman	Disney Classics	spotify:track:1HQHvjqGXTZWsHT2tN5CgI
L'arlesienne Suite No. 2 (version for piano): IV. Farandole	Georges Bizet, Julia Severus	Bizet: Complete Piano Music	spotify:track:1aOMczw6sCygUYY60TY6OW
This Is Berk	John Powell	How To Train Your Dragon (Music From The Motion Picture)	spotify:track:1g3Bc80hioYOSitxntNQYi
Nocturne No. 2 in E-Flat Major, Op. 9	Henrik Måwe	Best - Chopin	spotify:track:1vXUFMDrHzpHYwvLYlHzay
Don't You Worry Child - Radio Edit	Swedish House Mafia, John Martin	Don't You Worry Child	spotify:track:2V65y3PX4DkRhy1djlxd9p
Junk Of The Heart (Happy)	The Kooks	Junk Of The Heart	spotify:track:2jZgzSxNSg1hTCq0ewWHGJ
We Are Young	Vitamin String Quartet	VSQ Performs The Hits of 2012, Vol.1	spotify:track:2o991Ia3BuF7cRw30LFxSW
Love Theme (from "Blank: A Vinylmation Love Story")	Alfred Montejano	Love Theme (from "Blank: A Vinylmation Love Story")	spotify:track:2q0LIW5z491N1CEpW7t2iL
Cups (Pitch Perfect’s “When I’m Gone”) - Pop Version	Anna Kendrick	Cups (Pitch Perfect’s “When I’m Gone”)	spotify:track:2sCl0FFOzZSmYZs90zOpd1
Let It Go	The Piano Guys	Let It Go	spotify:track:3Tnwc30tpPO0U7RWcf0ZYj
Roar	Katy Perry	PRISM (Deluxe)	spotify:track:3bDGwl0X3EjQmIyFD1uif5
Kung Fu Piano: Cello Ascends	Henry Jackman, John Powell, Hans Zimmer, Frédéric Chopin, The Piano Guys	Kung Fu Piano: Cello Ascends	spotify:track:40UZVYjxavgxbsXRXkDtVZ
Theme From Schindler's List	John Williams, Itzhak Perlman, Boston Symphony Orchestra	Schindler's List	spotify:track:42gZM6AQ9BDMaTyTmMDVlN
Guardians At the Gate	Audiomachine	Chronicles	spotify:track:4MUN6PQPplQDajjx7NCcdr
Wake Me Up	Avicii	Wake Me Up	spotify:track:4QRZirU4s1f30iDHzuKncj
Take a Walk	Passion Pit	Gossamer	spotify:track:4Sfa7hdVkqlM8UW5LsSY3F
Counting Stars	OneRepublic	Native (Deluxe)	spotify:track:519uJbE3zyKLlToVA65PrP
We Are The Champions - Remastered 2011	Queen	Queen 40 Limited Edition Collector's Box Set Vol. 2	spotify:track:2U9v51tNOoLRhwrU6j83uU
Tonight Tonight	Hot Chelle Rae	Whatever	spotify:track:2i0AUcEnsDm3dsqLrFWUCq
Haruka Kanata [from Naruto]	RMaster, Dai	New Anime Nation, Vol.5	spotify:track:3SEToPG4lmFPkjduTxPWbs
Can't Hold Us - feat. Ray Dalton	Macklemore & Ryan Lewis	The Heist	spotify:track:3bidbhpOYeV4knp8AIu8Xn
Midnight In Moscow	Kenny Ball & His Jazzmen	Midnight In Moscow	spotify:track:3dVZsNXZWhBDUSjV2RkEWP
Happy	Simply Three	Two Worlds Collide	spotify:track:3xlhBNwoWYwSXRtiR1QMoi
The Cave	Vitamin String Quartet	VSQ Performs Modern Rock Hits 2011. Vol.1	spotify:track:4EGaV2GUMZk59yHkqDi1R3
The Cave	Mumford & Sons	Sigh No More	spotify:track:4YkmvF9kPRR0HOOK5XUxjZ
Save The World - Extended Mix	Swedish House Mafia	Save The World	spotify:track:4xTIknzHtjrqRQ1hlL2T8W
It's Time	Vitamin String Quartet	VSQ Performs Modern Rock Hits 2012 Vol. 1	spotify:track:3jLPOU6ZUucQnsRDp1bm3W
Hey Brother	Avicii	True	spotify:track:4RXpgGM7A4Hg7cFBoH5KyF
La valse d'Amélie - Version originale	Yann Tiersen	Amelie from Montmartre	spotify:track:508AvcfQL1jBYNdSrA1GVn
24 Préludes, Op. 28: No. 4 in E Minor. Largo	Frédéric Chopin, Rudolf Serkin	Chopin: 24 Préludes, Op. 28	spotify:track:1wGWlrYI4Y6lz4PEjdM881
Comptine d'un autre été, l'après-midi	Yann Tiersen	Amelie from Montmartre	spotify:track:2AkcjsKlRbIBYGAgpQVFii
Cristofori's Dream	David Lanz	Best Of David Lanz	spotify:track:2NiqUlgIt00byjqwaQ3ptB
Demons	Imagine Dragons	Night Visions	spotify:track:3LlAyCYU26dvFZBDUIMb7a
My Songs Know What You Did in the Dark (Light Em Up)	Vitamin String Quartet	VSQ Performs the Hits of 2013, Vol. 1	spotify:track:38Id1gWy1UMTx73RRlHkyv
On Top Of The World	Imagine Dragons	Night Visions (Deluxe)	spotify:track:4eLSCSELtKxZwXnFbNLXT5
Young and Beautiful	Vitamin String Quartet	VSQ Performs the Hits of 2013, Vol. 1	spotify:track:1pCQ6XHFC6JjVPc3CPkRMy
Little Talks	Of Monsters and Men	My Head Is An Animal	spotify:track:2ihCaVdNZmnHZWt0fvAM7B
All of Me	John Legend	Love In The Future (Expanded Edition)	spotify:track:3U4isOIWM3VvDubwSI3y7a
New	Paul McCartney	NEW (Deluxe Edition)	spotify:track:42qY6hJfpjia6a8nHL3Jg9
Just the Way You Are	Vitamin String Quartet	The Modern Wedding Collection, Vol. 2	spotify:track:4kp0h5eNegKkJXCCCVsuLu
Blackheart	Thomas Bergersen, Two Steps from Hell	SkyWorld	spotify:track:2jn89xTHIVsy167uOmAewt
What Have We Got?	Sting, Jimmy Nail	The Last Ship (Deluxe)	spotify:track:3Y75jAWIxBDNW2VvnedDJp
Bittersweet Symphony	Vitamin String Quartet	Strung Out, Vol. 7: VSQ Performs Music's Biggest Hits	spotify:track:32Z3rmSJLxqvfCIcODIJ8t
Test Drive - From How To Train Your Dragon Music From The Motion Picture	John Powell	How To Train Your Dragon (Music From The Motion Picture)	spotify:track:2QTDuJIGKUjR7E2Q6KupIh
Someone Like You	Adele	21	spotify:track:4kflIGfjdZJW4ot2ioixTB
Master Of The House	Sacha Baron Cohen, Helena Bonham Carter, Les Misérables Cast	Les Misérables: The Motion Picture Soundtrack Deluxe (Deluxe Edition)	spotify:track:3WoatVXvmr0qK7xVcVIyPi
Romantic Flight - From How To Train Your Dragon Music From The Motion Picture	John Powell	How To Train Your Dragon (Music From The Motion Picture)	spotify:track:51v7yO07BdGgP6hv0OaDe2
La valse d'Amélie - Version piano	Yann Tiersen	Amelie from Montmartre	spotify:track:1sScWpEFQBSsnwRnyFtycm
The John Dunbar Theme (film version)	John Barry	Dances With Wolves - Original Motion Picture Soundtrack	spotify:track:4NzyM0AAmN2ucaBlTXbQQT
Double Concerto in A Minor for Violin, Cello and Orchestra, Op. 102: III. Vivace non troppo	Johannes Brahms, János Starker, Henryk Szeryng, Bernard Haitink, Concertgebouworkest	The 50 Greatest Pieces for Violin	spotify:track:4lkNcAn7541M8Dk4A4yAGn
String Quintet in E Major, G. 282: III. Minuetto - Trio	Luigi Boccherini, David Parry, London Philharmonic Orchestra	99 Greatest Classical Composers	spotify:track:3zQYzGmqF3eF25m1tWe7iQ
Bach, J.S.: Violin Partita No. 2 in D Minor, BWV 1004: III. Sarabande	Johann Sebastian Bach, Itzhak Perlman	Bach: Solo Sonatas and Partitas	spotify:track:2RNp8lOSn0UtscIG57QQZM
The Last Ship	Sting	The Last Ship (Deluxe)	spotify:track:56qUBBEdeXNkq7JRDlJnJx
Rolling in the Deep	Simply Three	Rolling in the Deep	spotify:track:5VbeMAUiGyKHxacgMIBo8N
To Zanarkand - Final Fantasy X (Piano)	Dagmar Krug	Final Fantasy on Piano	spotify:track:68IAsAGuEtiqduPAxp6x7a
Counting Stars	Simply Three	Counting Stars	spotify:track:6sKyTORhJY0F4Lz7R7wOIK
I See Fire	Jun Sung Ahn	I See Fire	spotify:track:6wKhFodhJtx2hDCpOs6vPO
A Thousand Years	Juncurryahn	Juncurryahn	spotify:track:6z7Z5Q1krCbqLdh1It9MNp
I See Fire - From "The Hobbit: The Desolation of Smaug"	The Starlite Orchestra	Best of 2013: Movie	spotify:track:5LxEOxxF62P5JGW0kQuq9G
Waltz, Op. 64 No 2 (Arr. for Cello and Piano)	Frédéric Chopin, Sara Sant'Ambrogio, Robert Koenig	The Chopin Collection	spotify:track:6Z1XzduXAZ7f32rXkktEyG
Partita No. 2 in D Minor for Solo Violin, BWV 1004: V. Chaconne	Johann Sebastian Bach, Conrad von der Goltz	100 Pieces of Classical Music For Your Brain	spotify:track:7h3rOEiQpbMqJB9K0a1IZh
Another One Bites The Dust - Remastered 2011	Queen	The Game (Deluxe Remastered Version)	spotify:track:57JVGBtBLCfHw2muk5416J
Best Day Of My Life	American Authors	Oh, What A Life	spotify:track:5Hroj5K7vLpIG4FNCRIjbP
Cups	Piano Tribute Players	Top 20 Hits August 2013	spotify:track:5bs8Fdg2Fk7UY4cJwtYYl7
It's Time	Imagine Dragons	Night Visions	spotify:track:6BtmXhTJMM9sBTHeYYASGz
Daylight	Maroon 5	Overexposed (Deluxe)	spotify:track:6TwfdLbaxTKzQi3AgsZNzx
We Are Young (feat. Janelle Monáe)	fun., Janelle Monáe	Some Nights	spotify:track:7a86XRg84qjasly9f6bPSD
Married Life	Michael Giacchino	Up (Original Motion Picture Soundtrack)	spotify:track:7iocNjLrxPHLl8njgRlv5U
War, What Is It Good For?	Ugly Rumours	Viva Palestina	spotify:track:7jZRc5Nd8TIJVJh21kx3ni
Queenie Eye	Paul McCartney	NEW (Deluxe Edition)	spotify:track:5GoINZf00wT5g1i7pWhXJF
Scream & Shout	will.i.am, Britney Spears	#willpower (Deluxe)	spotify:track:5r6YGzvr9oZGVK6QVbh0HB
Locked Out of Heaven	Piano Tribute Players	35 More Piano Pop Hits of 2013	spotify:track:7zY0vAfP7gQyjd7CODXEte
Happy - From "Despicable Me 2"	Pharrell Williams	G I R L	spotify:track:5b88tNINg4Q4nrRbrCXUmg
Why Am I the One	fun.	Some Nights	spotify:track:5QbQ5iAebksB5Wj5BPazNX
Waltz, Op. 64 No. 2 in C-Sharp Minor - Remastered	Frédéric Chopin, Arthur Rubinstein	Chopin Waltzes & Impromptus: Classic Library Series	spotify:track:6gNNfaX2u0n8nWSdqVqVsC
Tears For Alice	David Lanz	Finding Paradise	spotify:track:7eKpDgmIG5ecPdidBEJhvz
Count on Me	Bruno Mars	Doo-Wops & Hooligans	spotify:track:7l1qvxWjxcKpB9PCtBuTbU
See You Tomorrow	John Powell	How To Train Your Dragon (Music From The Motion Picture)	spotify:track:7D9Jhcu3r5UcVbqwKuZKsV
The Cello Song	The Piano Guys	The Piano Guys	spotify:track:5uEcslrmFzkDqTaFB26yj2
Theme From "Megamind (Giant Blue Head)"	Movie Sounds Unlimited	Movie Hits 2011 Vol. 1	spotify:track:6Oi0CF6b4risxSJnOFj6P8
La valse d'Amélie - Version orchestre	Yann Tiersen	Amelie from Montmartre	spotify:track:7zD9LsiTq3EtPjhHBmJO3j
Nuvole Bianche	Ludovico Einaudi	The Classical Album 2011	spotify:track:5M7PLCga9phVW4eQkgmICf
Show Some Respect	Sting	The Last Ship (Deluxe)	spotify:track:7E5wa1T8UFQuQyYFmZRWvU
Adagio for Strings, Op. 11 No. 2 (From "Platoon")	Samuel Barber, The City of Prague Philharmonic Orchestra	100 Greatest Classical Pieces	spotify:track:00YHvYUPzfR7qvcESJKqEu
Guilty of Being Innocent of Being Jack Sparrow - From "Pirates of the Caribbean: On Stranger Tides"/Score	Hans Zimmer	Pirates of the Caribbean: On Stranger Tides	spotify:track:0ahHgsbKvBEd3yYQmxHBoj
Glad You Came	The Wanted	Glad You Came	spotify:track:1OXfWI3FQMdsKKC6lkvzSx
Yellow Submarine	Vitamin String Quartet	VSQ Performs The Beatles, Vol. 2	spotify:track:1PTdhuGxA5yOhgGaoPOV1k
Pompeii	Vitamin String Quartet	VSQ Performs the Hits of 2013, Vol. 2	spotify:track:1IIUewLfoCX61YOVajOpSt
Charlie Brown	Vitamin String Quartet	Vitamin String Quartet Performs Coldplay's Mylo Xyloto	spotify:track:069qngbFO4U9hyO8DKE6as
The Office (Main Theme) "Orchestral Version"	The Office Band	The Office (Theme from Tv Series)	spotify:track:1HkoGVUhNaA6KofCvCp3zd
Glorious Morning (CastleStorm Edition)	Waterflame	Castlestorm (Original Soundtrack)	spotify:track:1I332Wp9WKe0J80LWKSwdo
Together Forever	Pokémon	Pokemon X - Ten Years Of Pokemon	spotify:track:0TwWzcbMc1NCRe9EYWdjs3
A Thousand Years	Vitamin String Quartet	VSQ Performs Music from Twilight: Breaking Dawn, Pt. 1	spotify:track:14DhedBbPsU4bvOgGH2FDF
Viva La Vida	Coldplay	Viva La Vida or Death and All His Friends	spotify:track:1mea3bSkSGXuIRvnydlB5b
A Thousand Years	The Piano Guys	The Piano Guys	spotify:track:0E0xI4AgMNU7UkwBt3FCVN
My Name Is Lincoln	Steve Jablonsky	The Island (Original Motion Picture Soundtrack)	spotify:track:0iPGHWVM6qcTARzjk0eKxy
J'y suis jamais allé - Theme from "Amelie"	Mercuzio Pianist	Hidden Gems, Vol. 1	spotify:track:1tjYTA591mOo8jnAlk7T65
He's a Pirate	Klaus Badelt	Pirates of the Caribbean: The Curse of the Black Pearl (Original Motion Picture Soundtrack)	spotify:track:08QaHlMPWuO5PUxjl61bXn
Oogway Ascends (From "Kung Fu Panda" 2008) [Piano Version]	Magic Piano	Animated Movie Songs Vol. 1	spotify:track:2AbRBo6Ad8UIQYfwlJPyxt
Road to Glory	Audiomachine	Chronicles	spotify:track:0iY37NpRGCrK5AGfr4F6Qp
Cloud Atlas Finale	Tom Tykwer, Johnny Klimek, Reinhold Heil	Cloud Atlas: Original Motion Picture Soundtrack	spotify:track:0QAC1C2IV1SWqtCynfOaVC
Nocturnes, Op. 9: No. 2 in E-Flat Major	Finghin Collins	Best - Chopin	spotify:track:0I3GBYBKiRqk6h9YwNeKso
Waka Waka (This Time for Africa) [The Official 2010 FIFA World Cup (TM) Song] (feat. Freshlyground)	Shakira, Freshlyground	Waka Waka (This Time for Africa) [The Official 2010 FIFA World Cup (TM) Song] (feat. Freshlyground)	spotify:track:2Cd9iWfcOpGDHLz6tVA3G4
New York City Surprise	Hans Zimmer	Madagascar 3: Europe's Most Wanted (Music From The Motion Picture)	spotify:track:2cEbcEZWVrdBqIK1HJgV6f
Beyond the Sea (From "The Cafe")	Kathryn Williams, Adam Lipinski	Beyond the Sea (From "The Cafe")	spotify:track:3L8qAYBCrcMuVlWQfEsxsR
Pompeii	Bastille	Bad Blood	spotify:track:3gbBpTdY8lnQwqxNCcf795
Game of Thrones Theme Tune	London Music Works	Game of Thrones Theme Tune	spotify:track:3pXi9eU6cI8X3Kos2wiM7P
Radioactive	Imagine Dragons	Night Visions	spotify:track:4G8gkOterJn0Ywt6uhqbhp
Wake Me Up	Vitamin String Quartet	VSQ Performs the Hits of 2013, Vol. 2	spotify:track:4Y6IuL8GCahtErDgvPuwY7
Titanium / Pavane	The Piano Guys	The Piano Guys	spotify:track:4lAZaMGhx9Di03Vz9tfNzy
Vox Humana (As Featured By Digic Pictures)	Adam Balazs	Vox Humana (As Featured By Digic Pictures)	spotify:track:54bvqguBV0s8aQ2pqFW4kV
Firework	Dallas String Quartet	Red	spotify:track:5Y2g2734P6TcuJJmDwz9QO
The Office (Main Theme)	The Office Band	The Office (Theme from Tv Series)	spotify:track:6dmoz3Ml53Etq42jauAMg1
Discombobulate	Hans Zimmer	Sherlock Holmes (Original Motion Picture Soundtrack)	spotify:track:73GjO4GovgH7atouhm0rsW
Fade Into Darkness - Instrumental Club Mix	Avicii	Fade Into Darkness	spotify:track:2TIvnrDe9InJgIir87sfjC
The Medallion Calls	Klaus Badelt	Pirates of the Caribbean: The Curse of the Black Pearl (Original Motion Picture Soundtrack)	spotify:track:35gFlKdC4Pmo88Go1cVrae
Set Fire to the Rain	Vitamin String Quartet	VSQ Performs Adele	spotify:track:35lwaSbDUECrepb34eU0di
Get Lucky	Vitamin String Quartet	VSQ Performs the Hits of 2013, Vol. 1	spotify:track:3w4PiX4lYHZEif7mgaSqZe
Heart of Courage	Thomas Bergersen, Two Steps from Hell	Invincible	spotify:track:4JtvyWkWQTPVcroZf8JJkp
Concerning Hobbits	Howard Shore	The Lord of the Rings: The Fellowship of the Ring (Original Motion Picture Soundtrack)	spotify:track:644es5aYPJghtZLjM1rmSP
Safe and Sound	Vitamin String Quartet	VSQ Performs the Hits of 2013, Vol. 1	spotify:track:2MOIPyRXw0jerVZmefEsYS
He's A Pirate	David Garrett	David Garrett	spotify:track:4XN6ZKQ9ol7TCClDxtfGcZ
Viva la Vida	Piano Tribute Players	Tribute to Coldplay	spotify:track:4kFMCCLGxYDXXK7VNB41Ug
Davy Jones	Hans Zimmer	Pirates of the Caribbean: Dead Man's Chest (Original Motion Picture Soundtrack)	spotify:track:6buHoQU9OTdbJrAuniVwGL
Us Against the World	Vitamin String Quartet	Vitamin String Quartet Performs Coldplay's Mylo Xyloto	spotify:track:2YwYrdetGyqnlnx5jDEtv2
Someone Like You	Vitamin String Quartet	VSQ Performs Adele	spotify:track:2clLLo5fLWFfcWpeFgw0cm
Game On	Hans Zimmer	Madagascar 3: Europe's Most Wanted (Music From The Motion Picture)	spotify:track:2gKkcUfH7CVS9XnuGWHO5d
Smooth Criminal	Dallas String Quartet	Red	spotify:track:6Bc3XhStxljt3cLONJ23So
Radioactive	Vitamin String Quartet	VSQ Performs Modern Rock Hits 2012, Vol. 2	spotify:track:6wRNGHvh8UaJ9H50yJcbBg
Over the Rainbow / Simple Gifts	The Piano Guys	The Piano Guys	spotify:track:3TgaPzOX2706KUeTyA7DFx
Light The Hoop On Fire!	Hans Zimmer	Madagascar 3: Europe's Most Wanted (Music From The Motion Picture)	spotify:track:2HVRuH1So7RDCYXpSBCA3a
Viva La Vida	Vitamin Piano Series	Vitamin Piano Series: Tribute to Rock Hits, Vol.1	spotify:track:3j0e5xmac0C6jHNuRhsKV2
Nero	Thomas Bergersen, Two Steps from Hell	Archangel	spotify:track:4fCrXuvUtqeY6Hf7J6dSM8
Viva La Vida	Vitamin String Quartet	Vitamin String Quartet Performs Coldplay's Viva La Vida	spotify:track:6RIsyUfaodwn6yDxJ83Nzp
Fur Power!	Hans Zimmer	Madagascar 3: Europe's Most Wanted (Music From The Motion Picture)	spotify:track:2WGfuAHDlxRVRk8PTL6Iwo
Where the Streets Have No Name	Dallas String Quartet	Between Us	spotify:track:4nYCzbAEB4osgZVNAeXkUl
Bittersweet Symphony	Dallas String Quartet	Eclectric	spotify:track:2qZ36jzyP1u29KaeuMmRZx
Love And Be Loved	Geoff Zanelli	The Odd Life of Timothy Green	spotify:track:3q3lvXaixKuwfeKIs7ceLu
Love Always Comes As A Surprise	Peter Asher	Madagascar 3: Europe's Most Wanted (Music From The Motion Picture)	spotify:track:41V0xv9duWxKziGbAcgEGm
Bohemian Rhapsody	Dallas String Quartet	Between Us	spotify:track:53t6bDMGcCBm32I040Afxm
I Want To Be A Hero	Pokémon	Pokemon X - Ten Years Of Pokemon	spotify:track:5xVR05GfU8VGu5p8d8AXsl
Welcome to Vikingland	Waterflame	Castlestorm (Original Soundtrack)	spotify:track:5tAZkTBQ2znyn9MU80x3Tq
Battle Frontier	Pokémon	Pokemon X - Ten Years Of Pokemon	spotify:track:77aXxfz34fGbXKpoN1y0Il
Snow (Hey Oh)	Vitamin String Quartet	Strung Out, Vol. 3: VSQ Performs Alternative Hits	spotify:track:78car4iVp9ekXn4jdY8qLE
Seven Nation Army - Live	Vitamin String Quartet	VSQ Live at Troubadour	spotify:track:4CmRuNab9e8dl7uzM2uyjZ
He's A Pirate - Tiësto Remix	Hans Zimmer, Klaus Badelt, Geoff Zanelli, Tiësto	Pirates of the Caribbean: Dead Man's Chest (Original Motion Picture Soundtrack)	spotify:track:6NMBkgLg85thMr80ShrW8D
Time	Hans Zimmer	Inception (Music From The Motion Picture)	spotify:track:6ZFbXIJkuI1dVNWvzJzown
Moonlight Sonata: Adagio Sostenuto	Ludwig van Beethoven	Classical Best Of	spotify:track:6onVtBLxZpq4cwMa3fUMJs
Oogway Ascends	Hans Zimmer, John Powell	Kung Fu Panda	spotify:track:3JX2XXNXlgpBnnqDlw2UTX
Kung Fu Fighting	CeeLo Green, Jack Black	Kung Fu Panda	spotify:track:6WtIT4162EtLwGNx9GZgy3
Glad You Came	Piano Tribute Players	Piano Tribute to The Hangover	spotify:track:6Qb8zWcLowJbi76cdeQbTJ
Exposition	Takénobu	Exposition	spotify:track:1UaVnPuAOwgmlIIDJbRE1k
No Place Like London	Stephen Sondheim, Len Cariou, Victor Garber, Merle Louise, Paul Gemignani	Sweeney Todd: The Demon Barber of Fleet Street (Original Broadway Cast Recording)	spotify:track:4FqRbcFtoTY9B9QbFffTOY
Let's Call The Whole Thing Off	Ella Fitzgerald, Louis Armstrong	Ella And Louis Again	spotify:track:5ilfSJucsKp1uYsNw6N2ix
Sticks & Stones	Jónsi	How To Train Your Dragon (Music From The Motion Picture)	spotify:track:6CdxafAJt9jsdQCDTOMc72
The Worst Pies in London	Stephen Sondheim, Angela Lansbury, Paul Gemignani	Sweeney Todd: The Demon Barber of Fleet Street (Original Broadway Cast Recording)	spotify:track:57dtwJobSi1FEf23SwgcvX
Friendship Before Love	Cellophane Roses	Friendship Before Love	spotify:track:2dv7Jf570NkaWlW7NcsYTa
Kiss Me	Stephen Sondheim, Sarah Rice, Victor Garber, Paul Gemignani	Sweeney Todd: The Demon Barber of Fleet Street (Original Broadway Cast Recording)	spotify:track:2qL00yPJrZQQE2jXMS46Ui
The Contest	Stephen Sondheim, Joaquin Romaguera, Paul Gemignani	Sweeney Todd: The Demon Barber of Fleet Street (Original Broadway Cast Recording)	spotify:track:0KH9tocpWgOwnr2bOcXlW8
Pirelli's Miracle Elixir	Stephen Sondheim, Angela Lansbury, Len Cariou, Ken Jennings, Joaquin Romaguera, Sweeney Todd: The Demon Barber of Fleet Street Original Broadway Cast Ensemble, Paul Gemignani	Sweeney Todd: The Demon Barber of Fleet Street (Original Broadway Cast Recording)	spotify:track:6RL40sdT4qBhXXolLZbquR
Alexander Hamilton	Leslie Odom Jr., Anthony Ramos, Daveed Diggs, Okieriete Onaodowan, Lin-Manuel Miranda, Phillipa Soo, Original Broadway Cast of Hamilton	Hamilton (Original Broadway Cast Recording)	spotify:track:4TTV7EcfroSLWzXRY6gLv6
You'll Be Back	Jonathan Groff, Original Broadway Cast of Hamilton	Hamilton (Original Broadway Cast Recording)	spotify:track:6OG1S805gIrH5nAQbEOPY3
What Comes Next?	Jonathan Groff	Hamilton (Original Broadway Cast Recording)	spotify:track:3D4J0o9w44QKFrBrYrSVJY
The Room Where It Happens	Leslie Odom Jr., Lin-Manuel Miranda, Daveed Diggs, Okieriete Onaodowan, Original Broadway Cast of Hamilton	Hamilton (Original Broadway Cast Recording)	spotify:track:2TK2KSrzXD6W01qjXVjNGh
I Know Him	Jonathan Groff	Hamilton (Original Broadway Cast Recording)	spotify:track:4eeN8erNIbW2osT0knz5vT
Stay	Vitamin String Quartet	VSQ Performs the Hits of 2017	spotify:track:2Vk2bNuGh2Zke8klEyEVw7
Shape of You	Vitamin String Quartet	VSQ Performs the Hits of 2017	spotify:track:5fAx5nkBA294M6MunnijOM
N***as in Paris	Vitamin String Quartet	Vitamin String Quartet Performs Kanye West	spotify:track:0Csw7L0w2V4gwFJWVBXOOx
Afraid	The Neighbourhood	I Love You.	spotify:track:7brQHA2CgQpcMBiOlfiXYb
Stuck On You	Meiko	The Bright Side	spotify:track:4mC9z0zqP2Fhfkede5fONn
Where Is My Mind	Maxence Cyrin	Novö Piano	spotify:track:4jNQkWhuzqrbqQuqanFFJ6
Killing Me Softly	C. J. Johnson	The Feel Sessions - Accoustic Set Vol. 1	spotify:track:5iR5GQnY5ds7mxizUUVyfl
Killing Me Softly With His Song	Fugees, Ms. Lauryn Hill	The Score (Expanded Edition)	spotify:track:0Q0IVlqMV64kNLlwjPj0Hl
All About That Bass	Meghan Trainor	All About That Bass	spotify:track:0ifSeVGUr7py5GggttDhXw
Unravel [Tokyo Ghoul]	Eddie van der Meer	Anime Songs #1	spotify:track:0mqQue7PeoxcmJlGs3Z1GV
Animal Magic	Laurie Johnson	Classic Television and Radio Themes	spotify:track:3g5wgCXd5dCnaiamPe4y79
Intro	The xx	xx	spotify:track:0DAsxISzun85PbsqAfIzeC
Glassworks: I. Opening	Philip Glass, Philip Glass Ensemble, Michael Riesman	Glassworks - Expanded Edition	spotify:track:4gdwUYVnVv8u0t6XaYob4v
Opening	Philip Glass, Bruce Brubaker	Hope Street Tunnel Blues: Music for Piano By Philip Glass and Alvin Curran	spotify:track:1QmhkjuUlosROqKk59sBSK
Sweater Weather	The Neighbourhood	I Love You.	spotify:track:2QjOHCTQ1Jl3zawyYOpxh6
It Don't Mean A Thing	Ella Fitzgerald	Ella Fitzgerald Sings The Duke Ellington Songbook (Expanded Edition)	spotify:track:1UhHGEv3ttJIt6zHmOaqUP
It Don't Mean a Thing (If It Ain't Got That Swing)	Duke Ellington	Ken Burns Jazz-Duke Ellington	spotify:track:3FexBqEnmKPUttfXtwRDR6
It Don't Mean a Thing (If It Ain't Got That Swing) - 1990 Remaster	Louis Armstrong, Duke Ellington	The Great Summit - The Master Tapes	spotify:track:1WKTkC39vzDRxt9ZWA8iAQ
It Don't Mean a Thing	Proleter	Feeding the Lions EP	spotify:track:06SN95lC2QIwGchwTSQNY6
Am I Wrong	Nico & Vinz	Black Star Elephant	spotify:track:1fidCEsYlaVE3pHwKCvpFZ
Soir De Dispute	Gus Viseur	French Accordion Classics	spotify:track:7qIIcxh5XmeWN2TaqM2i6n
Somewhere Only We Know	Keane	The Best Of Keane (Deluxe Edition)	spotify:track:7AQAlklmptrrkBSeujkXsD
Chivalry Is Dead	Trevor Wesley	Chivalry Is Dead - Single	spotify:track:6kOrmPz9pkGzL4umBBRmWy
Suis-moi	Cyrille Aimee	Suis-moi	spotify:track:4HWsG9xQfXGFon8zKDZFjJ
Lovers in Japan	Coldplay	Viva La Vida or Death and All His Friends	spotify:track:5qPGi9p8VqcizfdgWxtmLt
Charlie Brown	Coldplay	Mylo Xyloto	spotify:track:1yqMgZNrevsWMLWfO2PRp5
Beautiful Now	Zedd, Jon Bellion	True Colors	spotify:track:2ISSQPb9LHHiV6ng2NXosL
Aawara Hoo	Amir Khan	Bollywood Songs	spotify:track:4ePFhnXN0vPxrOjwkHlzzv
Mo Bounce	Iggy Azalea	Mo Bounce	spotify:track:57nIrfsmlBYZO5fs4gbo0f
When You're Smiling (Bonus Track)	Leftover Cuties	Game Called Life EP	spotify:track:0NdyJaHANZf5x0BONp3Bij
Trouble	Leftover Cuties	Departures	spotify:track:2pcylNolEMPVgA5tYHug7l
Stay	Zedd, Alessia Cara	Stay	spotify:track:6uBhi9gBXWjanegOb2Phh0
Despacito - Remix	Luis Fonsi, Daddy Yankee, Justin Bieber	Despacito Feat. Justin Bieber (Remix)	spotify:track:6rPO02ozF3bM7NnOV4h6s2
No Promises (feat. Demi Lovato)	Cheat Codes, Demi Lovato	No Promises (feat. Demi Lovato)	spotify:track:5lNuqFVMca4vPupY10cH0J
Sexual Healing	Hot 8 Brass Band	Rock With the Hot 8	spotify:track:4QqrDluEDwmuxnH4Y3H346
(I Feel Like) Bustin Loose - Bonus Track	Rebirth Brass Band	The Main Event: Live at the Maple Leaf	spotify:track:2rU72ngd9DW5MzxzEgq7KH
Bang Bang	Joe Cuba	Fania Latin Boogaloo Essentials	spotify:track:4WHenMegy6rIakCNg98Vxf
The Champ - Original Version	The Mohawks	The Champ	spotify:track:4hnMzvdIsKx36K0sbVeW1c
Symphony No. 5 in D Minor, Op. 47: IV. Allegro non troppo	Dmitri Shostakovich, USSR State Symphony Orchestra, Yevgeny Svetlanov	Shostakovich: All Symphonies	spotify:track:4BY14het7sWAcNppUJICoO
Songs I Can't Listen To	Neon Trees	Songs I Can't Listen To	spotify:track:1WMBlpjhd3AUQiNfJOzfIl
With A Little Help From My Friends - Remastered 2009	The Beatles	Sgt. Pepper's Lonely Hearts Club Band (Remastered)	spotify:track:2RnPATK99oGOZygnD2GTO6
Serenade for Strings, Op. 20: III. Allegretto	Edward Elgar, Tamsin Waley-Cohen, David Curtis, Orchestra of the Swan	Vaughan Williams: The Lark Ascending, Violin Concerto in D Minor - Elgar: Introduction & Allegro, Serenade for Strings	spotify:track:4PN1b57lGGgflAwBAlBLYZ
Serenade for Strings, Op. 20: II. Larghetto	Edward Elgar, Tamsin Waley-Cohen, David Curtis, Orchestra of the Swan	Vaughan Williams: The Lark Ascending, Violin Concerto in D Minor - Elgar: Introduction & Allegro, Serenade for Strings	spotify:track:271SqhE3z0L6UmdP2H3Tpw
Danzas argentinas, Op. 2: II. Danza de la moza donosa (Dolcemente espressivo)	Alberto Ginastera, Francois Xavier Poizat	Ginastera: Danzas Argentinas, Piano Sonata 1, Suite de danzas criollas, 3 Pieces	spotify:track:0iU4WfDbJIynKU16r8jFaV
Bourbon Street Parade	Louis Armstrong & The Dukes of Dixieland	Louis and the Dukes	spotify:track:2f7AunfzQjjSj4R3COOo1j
Washington and Lee Swing	Louis Armstrong & The Dukes of Dixieland	Louis and the Dukes	spotify:track:6EWwfaSYFkvVmWLA9n5teH
Avalon	Louis Armstrong & The Dukes of Dixieland	Louis and the Dukes	spotify:track:3ijmE5aBPrtywYoiiyzjSZ
New Orleans	Louis Armstrong & The Dukes of Dixieland	Louis and the Dukes	spotify:track:0fYsDWVyltO3ZMFvVqFAln
Thats A Plenty	Louis Armstrong & The Dukes of Dixieland	Louis and the Dukes	spotify:track:2LV65Ly1B99hd1e73Jls1l
Just a Closer Walk With Thee	Louis Armstrong & The Dukes of Dixieland	Louis and the Dukes	spotify:track:515f8oHXlhFG7L2mhswxxp
Dixie	Louis Armstrong & The Dukes of Dixieland	Louis and the Dukes	spotify:track:7fHCfW1EH0KLOmLcywmm2i
Sheik of Araby	Louis Armstrong & The Dukes of Dixieland	Louis and the Dukes	spotify:track:6r08ADgrngwOsg1asB65wD
Wolverine Blues	Louis Armstrong & The Dukes of Dixieland	Louis and the Dukes	spotify:track:58hTsGudFjUkUrpuZRzG6a
Sweet Georgia Brown	Louis Armstrong & The Dukes of Dixieland	Louis and the Dukes	spotify:track:0jDjVO6WQLQjUMYSvi2bxz
Absolutely Smitten	dodie	Intertwined - EP	spotify:track:71SidvkT6LCBHRZI858TsQ
Oberon, J. 306: Overture	Carl Maria von Weber, Staatskapelle Dresden, Giuseppe Sinopoli	Edition Staatskapelle Dresden, Vol. 35: Giuseppe Sinopoli (Live)	spotify:track:31Uja5xtPa1nKKM5ZJPro4
1,2,3,4	Vitamin String Quartet	Emo Makeout Compilation	spotify:track:0lwSGZswQ09nbQMsiRbypI
Serenade for Strings, Op. 20: I. Allegro piacevole	Edward Elgar, Tamsin Waley-Cohen, David Curtis, Orchestra of the Swan	Vaughan Williams: The Lark Ascending, Violin Concerto in D Minor - Elgar: Introduction & Allegro, Serenade for Strings	spotify:track:40xQEvYOkcKZPE5NwUrZEG
Bei Mir Bist Du Schoen	The Hot Sardines	The Hot Sardines	spotify:track:2u6Rfw5UMX6Ofo1fiXKU18
Misery Business	Vitamin String Quartet	Emo Makeout Compilation	spotify:track:2PBGoJcD3JzCsWbmLM8lW7
Misery Business - Acoustic Version	Paramore	Riot!	spotify:track:3CFIo5d0MJM4xergOijeYD
Summertime	Louis Armstrong, Ella Fitzgerald	Porgy And Bess	spotify:track:7LHdSTKBYwB4GuiDwgsHri
Shape of You	Ed Sheeran	Shape of You	spotify:track:0FE9t6xYkqWXU2ahLh6D8X
Wake Up In Paris	The Hot Sardines	The Hot Sardines	spotify:track:3baBATYPz5tyc3LPqG9Ol4
Summertime - Instrumental	Willie "The Lion" Smith	Music On My Mind	spotify:track:3CTPUstYBBTjg0nfYAFn8N
Climb Every Mountain	The Broadway All Star Ensemble	The Sound of Music	spotify:track:3mKXE3XlLkMSzuk5xpCPTs
Mr. Sandman	Dickie Valentine	The Best of Dickie Valentine	spotify:track:24vTjC2mEiyyjVAbXyEdfy
Romeo and Juliet Suite: Montagues and Capulets	Sergei Prokofiev, Chicago Symphony Orchestra, Riccardo Muti	Prokofiev: Suite from Romeo & Juliet (Live)	spotify:track:5UbKh5BlL3w6YsBpMOiqO1
The Choice	Gustavo Santaolalla, Alan Umstead	The Last of Us	spotify:track:2IXJyG1DX93g2EhFXghz37
The Last of Us	Gustavo Santaolalla	The Last of Us	spotify:track:285ieonEuLkll3zknYK2TY
Overture to William Tell	Gioachino Rossini, Philadelphia Orchestra, Rossen Milanov	Rossini: Overture to William Tell - Shostakovich: Symphony No. 15	spotify:track:66Iu6L05W0gUzEngtnEHbe
Guillaume Tell (William Tell): Overture	Gioachino Rossini, Zagreb Festival Orchestra, Michael Halasz	Rossini: Overtures	spotify:track:5Cy4kZ3PgmhCNdPv0qyaAS
William Tell: Overture	Gioachino Rossini, Academy of St. Martin in the Fields, Sir Neville Marriner	Nessun Dorma - The Greatest Opera Pieces	spotify:track:1o91JiFEGxquecXGjBBDMU
Did You Mean It?	Original Dixieland Jazz Band	The Best of Dixieland	spotify:track:6ahZCwJ6rEFKYUapn8TW9A
Bourbon Street Parade	The Dukes Of Dixieland	New Orleans Jazz Collection - French Quarter Favorites	spotify:track:4QbweORkjDpipFhhLdEnYR
Hello, Dolly!	Louis Armstrong	Best of Jazz on Broadway	spotify:track:5xcWn0otFwAh9GRQvC27IA
Wolverine Blues	The Dukes Of Dixieland	The Dukes At Disneyland	spotify:track:13iL8Dd72zrSTC9DuQ50Pp
Ten Feet Tall	Wrabel	Ten Feet Tall	spotify:track:0XuhnKzXpHQYvCjycNVVdt
Cantina Band - From "Star Wars: A New Hope"	London Voices, London Symphony Orchestra, John Williams, New London Children's Choir	Star Wars Sampler	spotify:track:2zF7IDI6UsLXpwl3FjukPS
We're Going To Be Friends	The White Stripes	White Blood Cells	spotify:track:6u13tCUeMafkT0KFsmvodB
Hey There Delilah - Bonus Track	Plain White T's	Every Second Counts	spotify:track:3DWOTqMQGp5q75fnVsWwaN
Hey There Delilah	Vitamin String Quartet	The Modern Wedding Collection, Vol. 2	spotify:track:54lMsplqc0Cuj6zxfnpNoz
Help! - Remastered 2015	The Beatles	1 (Remastered)	spotify:track:3Smida2eCUsLzDcmZqXEZ3
I Want To Hold Your Hand - Remastered 2015	The Beatles	1 (Remastered)	spotify:track:4pbG9SUmWIvsROVLF0zF9s
City Of Stars - From "La La Land" Soundtrack	Ryan Gosling, Emma Stone	La La Land (Original Motion Picture Soundtrack)	spotify:track:6XQHlsNu6so4PdglFkJQRJ
Let Her Go	Vitamin String Quartet	VSQ Performs the Hits of 2013, Vol. 2	spotify:track:0jdawN7rLl2NmJpzLhQPt6
Mia & Sebastian’s Theme	Justin Hurwitz	La La Land (Original Motion Picture Soundtrack)	spotify:track:1Vk4yRsz0iBzDiZEoFMQyv
City Of Stars (Humming)	Justin Hurwitz, Emma Stone	La La Land (Original Motion Picture Soundtrack)	spotify:track:3gbwtdRrtD05lz08DTxfFt
Epilogue	Justin Hurwitz	La La Land (Original Motion Picture Soundtrack)	spotify:track:762K1h8yVV5IgAVuEMpqfZ
A Lovely Night	Ryan Gosling, Emma Stone	La La Land (Original Motion Picture Soundtrack)	spotify:track:4r9hiElqKWMPT4Z3vN2exq
Another Day Of Sun	La La Land Cast	La La Land (Original Motion Picture Soundtrack)	spotify:track:5kRBzRZmZTXVg8okC7SJFZ
Baby, It's Cold Outside - Pt. 1 & 2 / Live At Pasadena Civic Auditorium,1951	Louis Armstrong, Velma Middleton	Ella & Louis Christmas	spotify:track:3w3LGmMJa0K3VI6YfWfdY7
On The Sunny Side Of The Street - Live At Symphony Hall, Boston, MA/With Applause/1947	Louis Armstrong	Satchmo At Symphony Hall 65th Anniversary: The Complete Performances	spotify:track:4wAPQEXtVKv1BTUaG7DAXn
Hello, Dolly!	Louis Armstrong	By Popular Demand	spotify:track:7pnGf7VSdGcbHMtuqS5mfs
La Vie En Rose	Louis Armstrong	By Popular Demand	spotify:track:7ei0Oh8e7TuI4uBz0PNWRB
Summertime	Louis Armstrong, Ella Fitzgerald	By Popular Demand	spotify:track:2iTXZlaQcdIEIq0O96IvaH
Lalo: Symphonie espagnole in D minor, Op. 21: I. Allegro non troppo	Édouard Lalo, Renaud Capuçon, Paavo Järvi, Orchestre de Paris	Lalo: Symphonie espagnole - Bruch: Violin Concerto	spotify:track:4dKIE8KVxiokf3k4fBQ0vs
Haru Haru - Acoustic Version	BIGBANG	Remember	spotify:track:0poz4mXwjPUNGOiJv1eSU8
OUTRO : House Of Cards	BTS	화양연화 The Most Beautiful Moment In Life, Pt. 2	spotify:track:58Pgx0akyFKtKB0mmATT9M
Czárdás	Vittorio Monti, Sarah Nemtanu	Gypsic	spotify:track:4SXSk7qtWTIn02cT7SVTZ8
Blood Sweat & Tears	BTS	WINGS	spotify:track:0oSNOJEcBIKNcQzRc5TfyR
In the Mood	Glenn Miller	Greatest Hits	spotify:track:6dZKWYSx5YBIme4SfpIHJ0
2 Elegiac Melodies, Op.34: No. 2. Varen (Last Spring)	Edvard Grieg, Australian Chamber Orchestra, Richard Tognetti	Grieg: holberg suite - string quartet in g minor - 2 elegiac melodies - erotikk	spotify:track:5UHFMQ7CD8Bvj3ZxMBT7DJ
Delius: 3 Small Tone-Poems: No. 2, Winter Night "Sleigh Ride"	Frederick Delius, Sir Thomas Beecham, Royal Philharmonic Orchestra	20th Century Classics: Delius	spotify:track:1BU1OZ2g0YGdaKQBgX5EA0
Don't Let Me Down	Vitamin String Quartet	VSQ Performs the Hits of 2016, Vol. 2	spotify:track:2VOUq9FEUup5fB2bsUfOne
7 Years	Vitamin String Quartet	VSQ Performs the Hits of 2016, Vol. 1	spotify:track:1Fjw43JHGvAHPAm2Yozi4Z
Love Yourself	Vitamin String Quartet	VSQ Performs the Hits of 2016, Vol. 1	spotify:track:28NnTNYumoVjjrGq9UIF9m
Stitches	Vitamin String Quartet	VSQ Performs the Hits of 2016, Vol. 1	spotify:track:05kVAcx2g7LCpGYLrcEDZu
Hello	Vitamin String Quartet	VSQ Performs the Hits of 2015, Vol. 3	spotify:track:3JS98CgKuDNReMXNj2yaOg
Be Still	The Fray	Scars & Stories	spotify:track:3URt4lJQlANOstDBAWQJA7
The Duke	Miles Davis	Miles Ahead (Expanded Edition)	spotify:track:39ctrlu5OoDcVzP0nHvmv3
The Duke - Live	The Dave Brubeck Quartet	Dave Brubeck's Greatest Hits	spotify:track:4PueDlZNZ9tnHjjncSyOWg
Ni**as In Paris	JAY-Z, Kanye West	Watch The Throne (Deluxe)	spotify:track:2Zb7wnGUnNPCas2E0wWSQ5
Tchaikovsky: The Sleeping Beauty, Op. 66, Act I "The Spell": No. 6, Waltz	Pyotr Ilyich Tchaikovsky, André Previn, London Symphony Orchestra	Tchaikovsky: The Sleeping Beauty, Op. 66	spotify:track:1mmGGSpnrepCHV0Of7dBKg
Symphony No. 5 in C-Sharp Minor: IV. Adagietto. Sehr langsam	Gustav Mahler, Berliner Philharmoniker, Herbert von Karajan	Classic Karajan - The Essential Collection	spotify:track:0OpVdJ7YUIOZulbPh4wXr2
Les Preludes	Franz Liszt, Polish National Radio Symphony Orchestra, Michael Halasz	Liszt: Symphonic Poems, Vol. 1	spotify:track:3oYwpPMHASKBUe7DDa7cVF
Piano Concerto in A Minor, Op.16: I. Allegro molto moderato	Edvard Grieg, Javier Perianes, BBC Symphony Orchestra, Sakari Oramo	Grieg: Piano Concerto & Lyric Pieces	spotify:track:2Z4aQJh0kesRMookvtfR4y
Capriccio italien, Op. 45, TH 47	Pyotr Ilyich Tchaikovsky, Leonard Bernstein, New York Philharmonic	Tchaikovsky: 1812 Overture; Marche Slave; Romeo and Juliet; Capriccio Italien; Hamlet [Expanded Edition]	spotify:track:5HepI6E5fM3MAYJNSCwphN
I Won't Give Up	Jason Mraz	I Won't Give Up	spotify:track:05pKAafT85jeeNhZ6kq7HT
Somethin' Stupid	Frank Sinatra, Nancy Sinatra	The World We Knew	spotify:track:4feXcsElKIVsGwkbnTHAfV
Strangers In The Night	Frank Sinatra	Ultimate Sinatra	spotify:track:3O8s4pon1omITzB07t6oNx
Outlaws	Alessia Cara	Know-It-All (Deluxe)	spotify:track:6Vkpe06Bc5pbTrr9IBzOrs
Symphonic Variations, Op. 78, B. 70	Antonín Dvořák, London Philharmonic Orchestra, Sir Charles Mackerras	Dvorak: Symphony No. 8	spotify:track:4FpACmg8IyhueDsrvJ9gHH
Symphony No. 8 in G Major, Op. 88, B. 163: I. Allegro con brio	Antonín Dvořák, London Philharmonic Orchestra, Sir Charles Mackerras	Dvorak: Symphony No. 8	spotify:track:6kqumvF5kqUwoDMgSRvKeH
Symphony No. 8 in G Major, Op. 88, B. 163: II. Adagio	Antonín Dvořák, London Philharmonic Orchestra, Sir Charles Mackerras	Dvorak: Symphony No. 8	spotify:track:2ZbkB9kquh1GfCff9w0saK
Symphony No. 8 in G Major, Op. 88, B. 163: III. Allegretto grazioso - Molto vivace	Antonín Dvořák, London Philharmonic Orchestra, Sir Charles Mackerras	Dvorak: Symphony No. 8	spotify:track:6MdwnAOP7m7sLos2826F4G
Symphony No. 8 in G Major, Op. 88, B. 163: IV. Allegro ma non troppo	Antonín Dvořák, London Philharmonic Orchestra, Sir Charles Mackerras	Dvorak: Symphony No. 8	spotify:track:7rFw8XFIbwgJlrZRyYgPk0
Thnks fr th Mmrs	Fall Out Boy	Infinity On High	spotify:track:3Zwu2K0Qa5sT6teCCHPShP
Summer	Calvin Harris	Motion	spotify:track:6YUTL4dYpB9xZO5qExPf05
Closer	The Chainsmokers, Halsey	Closer	spotify:track:7BKLCZ1jbUBVqRi2FVlTVw
In the Name of Love	Martin Garrix, Bebe Rexha	In the Name of Love	spotify:track:23L5CiUhw2jV1OIMwthR3S
Scheherazade, Op. 35: IV. The Festival at Baghdad, The Sea, Shipwreck on the Rock Surmounted by a Bronze Warrior, Allegro Molto - Vivo - Allegro non troppo maestoso	Nikolai Rimsky-Korsakov, Royal Philharmonic Orchestra, Charles Dutoit	Rimsky-Korsakov: Scheherazade & Russian Easter Festival Overture	spotify:track:2cWTNwzl9EKgq3O6VxaUVb
Rhapsody in Blue	George Gershwin, Columbia Symphony Orchestra, Leonard Bernstein	Gershwin: Rhapsody in Blue & An American in Paris	spotify:track:7oB0QBEnGRIJjvlDc8YnM6
Take Yours, I'll Take Mine	Matthew Mole	The Home We Built (Deluxe Edition)	spotify:track:4c2Zdtqy5x9BkhTSJRTDmk
Bossa Dorado	Rose Room	Am I Blue	spotify:track:2SycN7qxPuMWLGdaxBClbD
Jazz Suite No. 2: VI. Waltz No. 2	Dmitri Shostakovich, Russian State Symphony Orchestra, Dmitry Yablonsky	The Very Best of Shostakovich	spotify:track:7H31EDn7KsAbZ74jRGZc3N
Hedwig's Theme (From "Harry Potter and the Philosopher's Stone")	John Williams, The City of Prague Philharmonic Orchestra	100 Greatest Classical Pieces	spotify:track:78PcUelsRrgVd1nOd1vMhc
Theme (From "Game of Thrones")	Ramin Djawadi, London Music Works	100 Greatest Classical Pieces	spotify:track:4SKVZhqIczYeN2vmy95SNE
Arrival of the Birds (From "The Crimson Wing Mystery of the Flamingos")	Jason Swinscoe, The City of Prague Philharmonic Orchestra	100 Greatest Classical Pieces	spotify:track:0h7aiRR56PVKT7Lit6U6GJ
St James Infirmary	Hugh Laurie	Let Them Talk	spotify:track:4eAlHTYUZvllH2dE2juVQZ
You Don't Know My Mind	Hugh Laurie	Let Them Talk	spotify:track:3YwHkFhsCB9WARodNJcERE
Six Cold Feet	Hugh Laurie	Let Them Talk	spotify:track:1qxvyvIFtWiV3QNkv17z10
Buddy Bolden's Blues	Hugh Laurie	Let Them Talk	spotify:track:0JwPDu04a32iQa2PU6ipBn
Battle of Jericho	Hugh Laurie	Let Them Talk	spotify:track:2HsUsb8EO0txxp62D9E1xT
After You've Gone	Hugh Laurie	Let Them Talk	spotify:track:30y1YKZbQ8rXRx2kl9cHo0
Swanee River	Hugh Laurie	Let Them Talk	spotify:track:6Ocp0AkuB53NneNMz0QufC
The Whale Has Swallowed Me	Hugh Laurie	Let Them Talk	spotify:track:1jjtUahX9eNe38aVgmrUB7
John Henry	Hugh Laurie	Let Them Talk	spotify:track:5lc7PQQVAXXEgTOqGkc0US
Police Dog Blues	Hugh Laurie	Let Them Talk	spotify:track:13ICn1TfMEB6DhYvc9dR6b
Tipitina	Hugh Laurie	Let Them Talk	spotify:track:1fGuu7bv6ynNigouDXxPwb
Winin' Boy Blues	Hugh Laurie	Let Them Talk	spotify:track:4ZKh2A9fNCvZOgnrP8YlbX
They're Red Hot	Hugh Laurie	Let Them Talk	spotify:track:193KvpAQZfWLznNqMBb5ul
Baby Please Make a Change	Hugh Laurie	Let Them Talk	spotify:track:2SuvEqASJscSJg9LOvS1Jp
Let Them Talk	Hugh Laurie	Let Them Talk	spotify:track:5CaADHIi7ksj6XN4dAKWCF
West Side Story: Overture	Leonard Bernstein, West Side Story Orchestra, Johnny Green	West Side Story (Original Motion Picture Soundtrack)	spotify:track:513mEnijhLWoGVhrFiU0Se
West Side Story: Act I: Prologue	Leonard Bernstein, West Side Story Orchestra, Johnny Green	West Side Story (Original Motion Picture Soundtrack)	spotify:track:68CJ6EJXhbmUOwkOk74w6N
West Side Story: Act I: Jet Song	Leonard Bernstein, Russ Tamblyn, Johnny Green, West Side Story Orchestra	West Side Story (Original Motion Picture Soundtrack)	spotify:track:6deWPW1vbOu5p1lBQOzkIw
West Side Story: Act I: Something's Coming	Leonard Bernstein, Jim Bryant, Johnny Green, West Side Story Orchestra	West Side Story (Original Motion Picture Soundtrack)	spotify:track:12duZc7sEBtgHsudXsJCy2
West Side Story: Act I: Maria	Leonard Bernstein, Jim Bryant, Johnny Green, West Side Story Orchestra	West Side Story (Original Motion Picture Soundtrack)	spotify:track:4PhC8QIdq2LcGm6KpXFaVi
West Side Story: Act I: America	Leonard Bernstein, Johnny Green, West Side Story Orchestra, Suzie Kaye, Betty Wand, George Chakiris	West Side Story (Original Motion Picture Soundtrack)	spotify:track:1RZ6jzlPeEaDeKYe7IJ792
West Side Story: Act I: Tonight	Leonard Bernstein, Jim Bryant, Marni Nixon, Johnny Green, West Side Story Orchestra	West Side Story (Original Motion Picture Soundtrack)	spotify:track:1T5t8mYCEihHpd9JOdLrd3
West Side Story: Act I: Gee, Officer Krupke	Leonard Bernstein, Russ Tamblyn, Johnny Green, Tony Mordente, David Winters, Eliot Feld, Bert Michaels, West Side Story Orchestra	West Side Story (Original Motion Picture Soundtrack)	spotify:track:5Yteiedw7vtcyUvYVPLhmv
West Side Story: Act I: Intermission Music	Leonard Bernstein, Johnny Green, West Side Story Orchestra	West Side Story (Original Motion Picture Soundtrack)	spotify:track:43Rll3g6Kb0EPfkbzAXyjw
West Side Story: Act II: I Feel Pretty	Leonard Bernstein, Johnny Green, Yvonne Othon, Suzie Kaye, Joanne Miya, Marni Nixon, West Side Story Orchestra	West Side Story (Original Motion Picture Soundtrack)	spotify:track:4JCBnb6zviWQjtlhxUgtis
West Side Story: Act II: One Hand, One Heart	Leonard Bernstein, Johnny Green, Jim Bryant, Marni Nixon, West Side Story Orchestra	West Side Story (Original Motion Picture Soundtrack)	spotify:track:7D4lCcfoygAp2lPOhMblqs
West Side Story: Act II: Tonight - Quintet	Leonard Bernstein, Johnny Green, Jim Bryant, Marni Nixon, Betty Wand, West Side Story Orchestra	West Side Story (Original Motion Picture Soundtrack)	spotify:track:4lMSP1iwlGVOUFIGJYXH9k
West Side Story: Act II: The Rumble	Leonard Bernstein, Johnny Green, West Side Story Orchestra	West Side Story (Original Motion Picture Soundtrack)	spotify:track:1y2lftzUk7w4olG8Nr5se4
West Side Story: Act II: Somewhere	Leonard Bernstein, Johnny Green	West Side Story (Original Motion Picture Soundtrack)	spotify:track:7DhQXwTYALJHMqoYaVaTFg
West Side Story: Act II: Cool	Leonard Bernstein, Tucker Smith, West Side Story Orchestra, Johnny Green	West Side Story (Original Motion Picture Soundtrack)	spotify:track:7hEELnHeb69CRA5DsPnNmz
West Side Story: Act II: A Boy Like That - I Have A Love	Leonard Bernstein, Johnny Green, Betty Wand, Marni Nixon, West Side Story Orchestra	West Side Story (Original Motion Picture Soundtrack)	spotify:track:55UULftUgr15ddW0V1KBSA
West Side Story: Finale	Leonard Bernstein, Johnny Green, West Side Story Orchestra, Marni Nixon	West Side Story (Original Motion Picture Soundtrack)	spotify:track:3sV25L24OgudtxeCMUMEQX
West Side Story: Act II: End Credits	Leonard Bernstein, Johnny Green, West Side Story Orchestra	West Side Story (Original Motion Picture Soundtrack)	spotify:track:4w3EeaD5rMqxEnD46PN44D
We Don't Talk Anymore (feat. Selena Gomez)	Charlie Puth, Selena Gomez	Nine Track Mind	spotify:track:37FXw5QGFN7uwwsLy8uAc0
Tchaikovsky: Violin Concerto in D Major, Op. 35: I. Allegro moderato	Pyotr Ilyich Tchaikovsky, Itzhak Perlman, Eugene Ormandy, Philadelphia Orchestra	Tchaikovsky: Violin Concerto & Sérénade mélancolique	spotify:track:0V6V6fwKxTHDrsLLmgW432
Tchaikovsky: Violin Concerto in D Major, Op. 35: I. Allegro moderato	Pyotr Ilyich Tchaikovsky, Yehudi Menuhin, Sir Adrian Boult, Royal Philharmonic Orchestra	Tchaikovsky: Violin Concerto	spotify:track:5gqO0ehwddCBStdAyCx5JR
I Only See You	Benton Paul	Grey	spotify:track:7bJO0FgM3tkRWIhP9FP4FM
Amar: Human I	Armand Amar, The City of Prague Philharmonic Orchestra	Human - OST	spotify:track:7eqD4SthjCwc9nVfvH4FZf
Amar: Castells	Armand Amar, The City of Prague Philharmonic Orchestra	Human - OST	spotify:track:0QInOSL2vIuEgrhBQg6zjT
Amar: Faces	Armand Amar, The City of Prague Philharmonic Orchestra	Human - OST	spotify:track:4cXscJTKH4QdHKerZIKnQO
i hate u, i love u (feat. olivia o'brien)	Garrett Nash, Olivia O'Brien	us	spotify:track:7vRriwrloYVaoAe3a9wJHe
La Vie En Rose	Daniela Andrade	La Vie En Rose	spotify:track:0VxocBntP1XTZRsR9ZURPS
Don't Let Me Down	The Chainsmokers, Daya	Don't Let Me Down	spotify:track:1i1fxkWeaMmKEB4T7zqbzK
Mendelssohn: Violin Concerto in E Minor Op. 64: I. Allegro molto appassionato	Felix Mendelssohn, Maxim Vengerov, Kurt Masur, Gewandhausorchester Leipzig	Bruch & Mendelssohn : Violin Concertos	spotify:track:3POMHYwwOaQZKpwQsQynkp
Overture	Mikhail Glinka, Fritz Reiner, Chicago Symphony Orchestra	Pictures At An Exhibition	spotify:track:3d7ricui0wokCfJfpUFexr
Across The Universe - Remastered 2009	The Beatles	Let It Be (Remastered)	spotify:track:4dkoqJrP0L8FXftrMZongF
Run or Hide - Acoustic	Run River North	Run or Hide (Acoustic)	spotify:track:5zhlwe6XjtY9McolYbaQ5G
Run or Hide	Run River North	Drinking from a Salt Pond	spotify:track:0gL2wxDmyNN71eEuCQUUfX
We Didn't Start the Fire	Billy Joel	Storm Front	spotify:track:3Cx4yrFaX8CeHwBMReOWXI
Mélodie No. 2 from Orphéus et Euridyce	Christoph Willibald Gluck, Isaac Stern	Encores	spotify:track:55XmLvZIGh4HKsq8QAe3UE
Blame (feat. John Newman)	Calvin Harris, John Newman	Motion	spotify:track:07nH4ifBxUB4lZcsf44Brn
Blame It on Me	George Ezra	Wanted on Voyage	spotify:track:2prdNAY0rlnRSEer2WDBMs
Lost	Kris Allen	Horizons	spotify:track:3nBmy2hAqIDmMOD0VZGB7I
Clocks	Coldplay	A Rush of Blood to the Head	spotify:track:0BCPKOYdS2jbQ8iyB56Zns
Song - String Version	Kidstreet	Song	spotify:track:0QsXub0ojwCEpV0zRye05R
Song	Kidstreet	Fuh Yeah	spotify:track:2qNn2NDJSjuXdmyNHdmUaq
Love Runs Out	OneRepublic	Native	spotify:track:5BJSZocnCeSNeYMj3iVqM7
Conqueror	AURORA	All My Demons Greeting Me As A Friend (Deluxe Version)	spotify:track:5nqof30JRAkvfxcj9cgS0n
Let Her Go	Passenger	All the Little Lights	spotify:track:6GmUVqe73u5YRfUUynZK6I
Beneath Your Beautiful - Live in Amsterdam	Passenger	Spotify Session	spotify:track:2yGTCdmOQI6ipDKAb8ERPQ
You Are Mine (feat. Holley Maher)	Spencer Combs	You Are Mine (feat. Holley Maher)	spotify:track:4dTRrcrG69otiofMT1ep2W
Hey Jude - Remastered 2015	The Beatles	1 (Remastered)	spotify:track:0aym2LBJBk9DAYuHHutrIl
Come Together - Remastered 2009	The Beatles	Abbey Road (Remastered)	spotify:track:2EqlS6tkEnglzr7tkKAAYD
Puff, the Magic Dragon	Peter, Paul and Mary	Moving	spotify:track:3hqsBLMAqJqrhr434Z7WlA
Try To Remember	The Brothers Four	Golden Anniversary	spotify:track:2XazAg94tjrg80zVpHsLzA
Me, Myself & I	G-Eazy, Bebe Rexha	When It's Dark Out	spotify:track:40YcuQysJ0KlGQTeGUosTC
Across the Stars (Love Theme from Star Wars: Episode II)	John Williams, London Symphony Orchestra	Star Wars Episode 2: Attack of the Clones	spotify:track:2QzCAcW1aA98LW8qMrgL5P
Painting Flowers	All Time Low	Painting Flowers	spotify:track:0AuNW1iBQUJoAnj5SlRjQP
Chelsea Dagger	The Fratellis	Costello Music	spotify:track:3ItzRpwvKtkDSNdRSjXu7Z
Strange Birds	Birdy	Fire Within	spotify:track:5qenS4Saf6EyIJ2yViBG9b
stones around the sun	Lewis Watson	the morning (all of the songs)	spotify:track:0JGbwcwPV0VfuR4zDcZ9ce
She Ain't You	New Hollow	She Ain't You	spotify:track:2Tegi5TDHuQRs39kpVwLoh
Don't Let Me Go	The Click Five	Tcv	spotify:track:07YGL0HwevJW1UxUXG15Gt
Final Fantasy X - To Zanarkand	Vitamin String Quartet	Geek Wedding, Vol. 2: The Sequel	spotify:track:6ZTsZ5MxoUa2jzPY5rvBPL
Star Wars - Cantina Band	Vitamin String Quartet	Geek Wedding, Vol. 2: The Sequel	spotify:track:0pxymb2x3zndnUuClOCPsY
Paint It Black	Vitamin String Quartet	VSQ Performs the Rolling Stones	spotify:track:2f1HZioXLj7GgxDtrnxbcJ
Paint It, Black - (Original Single Mono Version)	The Rolling Stones	Singles 1965-1967	spotify:track:7lY8aoN3wUR3NY4nUwigPv
Mano A Mano	Hugo Díaz	Tangos	spotify:track:6CqaWFOMbRL7bH3S2Py2Ds
Mi Buenos Aires Querida	Hugo Díaz	Tangos	spotify:track:59JU36JjDMDrcBYY5nS0lQ
Sad	Maroon 5	Overexposed (Deluxe)	spotify:track:2EUxbBRKE07EOWW8mBkg5q
Dangerously	Charlie Puth	Nine Track Mind	spotify:track:6GBMbvX7sqyOxT5wWK4hgN
The Scientist	Coldplay	A Rush of Blood to the Head	spotify:track:75JFxkI2RXiU7L9VXzMkle
Strings	Shawn Mendes	Handwritten	spotify:track:6xh6ke01Jn6or3vc9MnxyJ
Chasing Cars	Snow Patrol	Eyes Open	spotify:track:11bD1JtSjlIgKgZG2134DZ
My Gospel	Charlie Puth	Nine Track Mind	spotify:track:1RdykyqZss4snJH9e58CQJ
Dead In The Water	Ellie Goulding	Halcyon Days	spotify:track:5LPlIkilhrn4izTfNAutbC
Not About Angels	Birdy	Not About Angels	spotify:track:5sF7hdYvhrcgNq8NZjfK8L
Beating Heart	Ellie Goulding	Divergent: Original Motion Picture Soundtrack	spotify:track:1XbC2PUR09MlgmpVbLgF4L
String Quartet in F Major, Op. 96 - "American": String Quartet in F Major, Op. 96 - "American": II. Lento	Antonín Dvořák, Talich Quartet	Dvorak: "American" String Quartet in F Major, Op. 96 & "American" String Quintet in E-Flat Major, Op. 97	spotify:track:2kcO1IofYVQ1szmYX6vxJK
String Quartet in F Major, Op. 96 - "American": String Quartet in F Major, Op. 96 - "American": III. Molto vivace	Antonín Dvořák, Talich Quartet	Dvorak: "American" String Quartet in F Major, Op. 96 & "American" String Quintet in E-Flat Major, Op. 97	spotify:track:3ozlvV0L317czN0wHkx7Gx
String Quartet in F Major, Op. 96 - "American": String Quartet in F Major, Op. 96 - "American": IV. Finale. Vivace ma non troppo	Antonín Dvořák, Talich Quartet	Dvorak: "American" String Quartet in F Major, Op. 96 & "American" String Quintet in E-Flat Major, Op. 97	spotify:track:2j3JabJVVQkttv6HN7OaJM
String Quintet in E-Flat Major, Op. 97: String Quintet in E-Flat Major, Op. 97: I. Allegro non tanto	Antonín Dvořák, Talich Quartet, Jiri Zigmund	Dvorak: "American" String Quartet in F Major, Op. 96 & "American" String Quintet in E-Flat Major, Op. 97	spotify:track:3xMXdgbdlDKIu4A5EnUXze
String Quintet in E-Flat Major, Op. 97: String Quintet in E-Flat Major, Op. 97: II. Allegro vivo	Antonín Dvořák, Talich Quartet, Jiri Zigmund	Dvorak: "American" String Quartet in F Major, Op. 96 & "American" String Quintet in E-Flat Major, Op. 97	spotify:track:1zMdXc3dkuRXL2rins9Mbi
String Quintet in E-Flat Major, Op. 97: String Quintet in E-Flat Major, Op. 97: III. Larghetto	Antonín Dvořák, Talich Quartet, Jiri Zigmund	Dvorak: "American" String Quartet in F Major, Op. 96 & "American" String Quintet in E-Flat Major, Op. 97	spotify:track:1Im8d4E9jFpkQ6PKTZziH2
String Quintet in E-Flat Major, Op. 97: String Quintet in E-Flat Major, Op. 97: IV. Finale. Allegro giusto	Antonín Dvořák, Talich Quartet, Jiri Zigmund	Dvorak: "American" String Quartet in F Major, Op. 96 & "American" String Quintet in E-Flat Major, Op. 97	spotify:track:2kHKt5pGQcWGQyQFca9ffE
String Quartet in F Major, Op. 96 - "American": String Quartet in F Major, Op. 96 - "American": I. Allegro ma non troppo	Antonín Dvořák, Talich Quartet	Dvorak: "American" String Quartet in F Major, Op. 96 & "American" String Quintet in E-Flat Major, Op. 97	spotify:track:1MN2hoQVyjXjz7XxFkJDVv
Cough Syrup	Vitamin String Quartet	VSQ Performs The Hits of 2012, Vol.1	spotify:track:14gWfIreGnwu4NHuTEbDTs
Cough Syrup	Young the Giant	Young The Giant (Special Edition)	spotify:track:1UqhkbzB1kuFwt2iy4h29Q
Roses Of Picardy	Alfie Boe	Downton Abbey	spotify:track:0mQ4ekGIUV1Ceq4Oh89P0l
If You Were The Only Girl In The World	Alfie Boe	Downton Abbey	spotify:track:2lI4fTF4G0tJAQi63SJd63
I Found	Amber Run	5AM (Expanded Edition)	spotify:track:5zT5cMnMKoyruPj13TQXGx
Shark in the Water	The Cocktails	Another Round	spotify:track:3tWp93Y61r4j6ASXbJVUL9
I Love It When You Cry	Moxie Raia	I Love It When You Cry	spotify:track:6r3v7nkYQGiHfgNTrpRAwx
Eleanor Rigby - Remastered 2015	The Beatles	1 (Remastered)	spotify:track:0Wv8IXRUDZOfmFJHC1VOFI
Here Comes The Sun - Remastered 2009	The Beatles	Abbey Road (Remastered)	spotify:track:6dGnYIeXmHdcikdzNNDMm2
Help! - Remastered 2015	The Beatles	1 (Remastered)	spotify:track:1dfuJYDSIc41cw5RPsaCF1
Shadow	Sam Tsui	Make It Up	spotify:track:3de2MwPcOlFk86nq2ApLr9
Stitches	Shawn Mendes	Handwritten	spotify:track:3zkWCteF82vJwv0hRLba76
Drop the Game	Flume, Chet Faker	Lockjaw	spotify:track:4KtrE35pTuqwNc22QP58RT
Riptide	MisterWives	Spotify Sessions	spotify:track:1WbYFNSUNn9fP1x0Z5DU95
Rhythm Of Love	Plain White T's	Wonders Of The Younger	spotify:track:6MDTpYxPFL0wtFd0pjfKws
Stereo Hearts (feat. Adam Levine)	Gym Class Heroes, Adam Levine	The Papercut Chronicles II	spotify:track:0qOnSQQF0yzuPWsXrQ9paz
Renegades	X Ambassadors	VHS	spotify:track:0fYVliAYKHuPmECRs1pbRf
Marry You	Bruno Mars	Doo-Wops & Hooligans	spotify:track:22PMfvdz35fFKYnJyMn077
Overwhelmed	Tim McMorris	I'd Choose You Again	spotify:track:2iRg3z1lrFSQxXU4G7Unn3
Tu Meri	Vishal-Shekhar, Vishal Dadlani	Bang Bang (Original Motion Picture Soundtrack)	spotify:track:39TJkE0AEkfWii8VB3JqSV
Sicilienne, Op. 78 (arr. for orchestra)	Gabriel Fauré, Slovak Radio Symphony Orchestra, Ondrej Lenard	Clair De Lune - Classical Favourites for Relaxing and Dreaming	spotify:track:3pDST36MAGDsFjx9w2jSvP
Animal	Neon Trees	Habits	spotify:track:1fBl642IhJOE5U319Gy2Go
Burning House	Cam	Welcome to Cam Country - EP	spotify:track:1EPmjXdSdJgP08mrrmnw7h
Ways to Go	Grouplove	Spreading Rumours	spotify:track:57nNNkgk768QVXq3uHxu5e
Concerto Grosso In D Minor, Op. 3, No. 11, Rv 565: I. Allegro	Antonio Vivaldi, Capella Istropolitana	Vivaldi: L´Estro Armonico, Op. 3	spotify:track:5tGWf37h2JZbEQNds7glgd
Sarasate: Zigeunerweisen, Op. 20	Pablo de Sarasate, Itzhak Perlman, Abbey Road Ensemble	Paganini: Violin Concerto No.1 / Sarasate: Carmen Fantasy etc.	spotify:track:1Owa3Ic2vpcfRCLSqa73NZ
Do You Hear The People Sing?	Aaron Tveit, Eddie Redmayne, Students, Les Misérables Cast	Les Misérables: The Motion Picture Soundtrack Deluxe (Deluxe Edition)	spotify:track:03m03OVQGPuzt8Rw2r0a7t
Lucky	Kat Edmonson	Way Down Low	spotify:track:5w7iocU90UMdRQaOwNzpAp
Dreaming	Smallpools	Smallpools	spotify:track:3c7vquF4xacCmFrxztLUVH
The Fighter (feat. Ryan Tedder)	Gym Class Heroes	The Papercut Chronicles II	spotify:track:77ZdAoTHYoF6Umo76HFD4m
Hey Mama	Kanye West	Late Registration	spotify:track:46OFHBw45fNi7QNjSetITR
Greater	MercyMe	Welcome to the New	spotify:track:6eFGvG8mkvZJjhPx9wMZGc
Time Will Tell	Gregory Alan Isakov	The Weatherman	spotify:track:76PS07wzG7zYMy8rHPjL2t
Gravity Falls Main Title Theme (from "Gravity Falls")	Brad Breeck	Gravity Falls Main Title Theme (from "Gravity Falls")	spotify:track:0DhnpIeCaMp85Jyc39sUBy
Stay The Night - Featuring Hayley Williams Of Paramore	Zedd, Hayley Williams	Clarity (Deluxe)	spotify:track:1o4XQ7tYJrDxgEpJufbOI8
What Is Love	Kiesza	Sound Of A Woman	spotify:track:1YaN0cUxi7I9VTwPl7dOzc
What A Wonderful World	Louis Armstrong	Hello Louis - The Hit Years (1963-1969)	spotify:track:6Z5XZ8fjmWGbkdahOgreVe
What If	Five For Fighting	Bookmarks	spotify:track:4Qdup02dJrZ1jR3UgXY6Vj
Drifen	Shirl Jae Atwell, Canyon Vista Middle School Honor Orchestra, Elizabeth Frederick	2013 Texas Music Educators Association (TMEA): Canyon Vista Middle School Honor Orchestra	spotify:track:4P6gKnfIWnmzlgtZv699LM
Oceans (Where Feet May Fail)	Hillsong UNITED	Zion (Deluxe Edition)	spotify:track:5Mw9bXG1dLNhbjofkVS2oR
Stolen Dance	Milky Chance	Stolen Dance	spotify:track:5tjrH5xrpkgKgYd8zQgU8X

